PlayerID,player,age,team,comp_level,minutes_90s,birth_year,position,blocked_passes,blocked_shots,blocks,challenge_tackles,challenge_tackles_pct,challenges,challenges_lost,clearances,errors,interceptions,tackles,tackles_att_3rd,tackles_def_3rd,tackles_interceptions,tackles_mid_3rd,tackles_won
00242715,Moussa Niakhate,27,"Nott'ham Forest",Premier League,16.2,1996,DF,7,12,19,20,80.0,25,5,51,0,14,42,0,33,56,9,25
00242b75,Leandro Barreiro Martins,23,Mainz 05,Bundesliga,29.0,2000,MF,29,16,45,30,60.0,50,20,53,0,36,65,9,19,101,37,40
003cf4d1,Jayden Danns,17,Liverpool,Premier League,0.1,2006,FW,0,0,0,0,"",0,0,0,0,0,0,0,0,0,0,0
00459419,Marko Arnautovic,34,Inter,Serie A,8.9,1989,FW,7,1,8,4,57.1,7,3,5,0,5,10,2,3,15,5,4
0076ab7f,Nemanja Gudelj,31,Sevilla,La Liga,19.4,1991,"DF,MF",8,9,17,17,54.8,31,14,56,0,27,31,3,18,58,10,24
00953a9d,Mikey Moore,15,Tottenham,Premier League,0.0,2007,MF,0,0,0,0,"",0,0,1,0,0,0,0,0,0,0,0
00963611,Konstantinos Mavropanos,25,West Ham,Premier League,16.7,1997,DF,8,13,21,17,81.0,21,4,79,3,23,28,2,17,51,9,16
009a4f60,Julian Ryerson,25,Dortmund,Bundesliga,19.6,1997,DF,24,7,31,27,57.4,47,20,35,3,10,41,4,26,51,11,23
00a8d210,Przemyslaw Frankowski,28,Lens,Ligue 1,24.4,1995,DF,23,7,30,31,41.9,74,43,36,0,25,60,9,25,85,26,39
00b28772,Nemanja Maksimovic,28,Getafe,La Liga,36.3,1995,MF,33,23,56,23,56.1,41,18,61,0,46,65,8,26,111,31,43
00b77ecf,Nathan Fraser,18,Wolves,Premier League,2.1,2005,FW,1,1,2,1,33.3,3,2,2,0,1,5,2,2,6,1,2
00c9a283,Hugo Larsson,19,Eint Frankfurt,Bundesliga,21.0,2004,MF,27,7,34,15,53.6,28,13,30,1,29,32,4,18,61,10,18
00e36323,Florian Pick,27,Heidenheim,Bundesliga,3.6,1995,"MF,FW",2,0,2,2,66.7,3,1,2,0,2,4,1,3,6,0,4
00eba9c9,Selim Amallah,26,Valencia,La Liga,6.7,1996,"FW,MF",13,0,13,3,33.3,9,6,6,0,11,17,3,7,28,7,12
00f518d8,Faride Alidou,22,Köln,Bundesliga,14.2,2001,"FW,MF",21,2,23,4,22.2,18,14,15,1,8,10,1,3,18,6,4
0118c54c,Anthony Caci,26,Mainz 05,Bundesliga,27.6,1997,DF,36,7,43,27,61.4,44,17,45,0,32,56,1,30,88,25,23
011b2a32,Trevis Dago,18,Lille,Ligue 1,0.3,2005,"FW,MF",0,0,0,0,"",0,0,0,0,1,0,0,0,1,0,0
0127419a,Ianis Hagi,24,Alavés,La Liga,8.9,1998,"MF,FW",8,0,8,5,41.7,12,7,4,0,5,17,1,2,22,14,12
016ff750,Valentino Lazaro,27,Torino,Serie A,22.2,1996,"DF,MF",13,1,14,13,68.4,19,6,29,0,8,18,2,7,26,9,11
017018d1,Fabian Holland,33,Darmstadt 98,Bundesliga,20.4,1990,"MF,DF",10,12,22,20,54.1,37,17,29,0,24,47,8,18,71,21,26
0174ba21,Robin Hack,24,Gladbach,Bundesliga,15.0,1998,"FW,MF",16,0,16,4,23.5,17,13,21,0,14,15,2,6,29,7,8
01834aa0,Sebastiaan Bornauw,24,Wolfsburg,Bundesliga,15.9,1999,DF,9,12,21,13,68.4,19,6,81,0,18,26,0,19,44,7,12
01870104,Mohamed Lamine Bayo,25,Le Havre,Ligue 1,15.4,1998,FW,7,1,8,2,20.0,10,8,11,0,2,13,6,2,15,5,5
01bb93d5,Nicolas Paz,18,Real Madrid,La Liga,0.3,2004,"MF,FW",2,0,2,0,"",0,0,0,0,1,0,0,0,1,0,0
01becd60,Alan Virginius,20,Clermont Foot,Ligue 1,10.4,2003,FW,7,0,7,4,36.4,11,7,7,0,3,9,1,4,12,4,5
01c3aff5,Weston McKennie,24,Juventus,Serie A,28.8,1998,"MF,DF",21,7,28,17,63.0,27,10,69,0,18,48,6,31,66,11,29
01ce9e70,Kieffer Moore,30,Bournemouth,Premier League,1.2,1992,"FW,MF",0,0,0,0,"",0,0,0,0,0,0,0,0,0,0,0
01da7812,Myrto Uzuni,28,Granada,La Liga,27.2,1995,FW,16,3,19,6,22.2,27,21,7,0,4,18,3,8,22,7,14
01e5f06e,Sergio Gomez,22,Manchester City,Premier League,0.6,2000,"FW,MF",0,0,0,1,50.0,2,1,0,0,1,1,0,0,2,1,0
01eb744d,Angel Correa,28,Atlético Madrid,La Liga,17.0,1995,"FW,MF",13,0,13,5,29.4,17,12,6,0,2,22,8,3,24,11,15
01efac19,Antonin Barak,28,Fiorentina,Serie A,9.0,1994,"MF,FW",5,0,5,3,42.9,7,4,4,0,2,6,2,1,8,3,2
01fd01e8,Souleymane Toure,20,Lorient,Ligue 1,22.8,2003,DF,18,20,38,8,57.1,14,6,101,2,36,25,0,16,61,9,12
02319ad7,Jaime Mata,34,Getafe,La Liga,19.9,1988,"FW,MF",17,1,18,11,42.3,26,15,31,0,17,24,4,12,41,8,15
028e70b9,Joshua Zirkzee,22,Bologna,Serie A,30.7,2001,FW,23,2,25,13,54.2,24,11,36,0,3,32,9,8,35,15,20
02b29014,Abdoulaye Doucoure,30,Everton,Premier League,29.2,1993,"FW,MF",20,3,23,18,39.1,46,28,19,0,15,43,9,20,58,14,27
02b3733e,Lucas Mincarelli,19,Montpellier,Ligue 1,10.9,2004,"DF,MF",13,4,17,17,50.0,34,17,27,0,8,29,4,19,37,6,16
02bcaf8e,Bilal Brahimi,23,Brest,Ligue 1,2.5,2000,"FW,MF",3,0,3,0,0.0,3,3,0,0,0,0,0,0,0,0,0
02c15616,Marcos Llorente,28,Atlético Madrid,La Liga,28.5,1995,"MF,DF",25,11,36,16,36.4,44,28,35,0,14,40,5,18,54,17,23
02caf6e0,Manuel Lazzari,29,Lazio,Serie A,18.6,1993,DF,16,4,20,18,64.3,28,10,37,1,12,26,3,13,38,10,18
02d2c436,Luis Hernandez,34,Cádiz,La Liga,8.0,1989,DF,1,2,3,4,50.0,8,4,25,0,8,7,0,4,15,3,3
02ef8778,Raul de Tomas,28,Rayo Vallecano,La Liga,14.1,1994,FW,3,0,3,3,50.0,6,3,8,0,1,9,2,4,10,3,5
0302f7b4,Jastin Garcia,19,Girona,La Liga,0.4,2004,FW,0,0,0,0,"",0,0,1,0,0,1,1,0,1,0,0
0313a347,Ezri Konsa,25,Aston Villa,Premier League,34.1,1997,DF,16,20,36,23,85.2,27,4,73,3,28,54,3,28,82,23,32
032f894e,Renato Sanches,25,Roma,Serie A,1.6,1997,MF,2,0,2,2,66.7,3,1,1,0,0,2,0,1,2,1,1
036bba5f,Ruben Alcaraz,32,Cádiz,La Liga,34.8,1991,MF,46,14,60,50,41.3,121,71,55,2,33,97,6,39,130,52,59
0375723e,Simone Verdi,31,Torino,Serie A,0.0,1992,FW,0,0,0,0,"",0,0,0,0,0,0,0,0,0,0,0
039f01a9,Nuha Jatta,17,RB Leipzig,Bundesliga,0.0,2006,FW,0,0,0,0,"",0,0,0,0,0,0,0,0,0,0,0
039f1983,Joseph Okumu,26,Reims,Ligue 1,19.4,1997,DF,8,19,27,24,63.2,38,14,112,2,35,44,2,28,79,14,28
03edb878,Daniel Jebbison,19,Sheffield Utd,Premier League,0.2,2003,FW,1,0,1,0,"",0,0,0,0,0,0,0,0,0,0,0
03f946ed,Andrea Petagna,28,Cagliari,Serie A,11.1,1995,FW,3,3,6,1,50.0,2,1,4,0,1,4,3,1,5,0,2
0400dd2f,Badredine Bouanani,18,Lorient,Ligue 1,4.9,2004,MF,3,0,3,2,50.0,4,2,3,0,2,4,2,1,6,1,2
0420d84f,Seamus Coleman,34,Everton,Premier League,7.4,1988,DF,8,4,12,11,68.8,16,5,26,1,7,17,4,10,24,3,14
042e8a49,Kingsley Coman,27,Bayern Munich,Bundesliga,12.4,1996,FW,14,1,15,9,52.9,17,8,5,0,2,12,4,5,14,3,7
0442183b,Nathaniel Clyne,32,Crystal Palace,Premier League,14.9,1991,DF,12,6,18,14,66.7,21,7,33,0,10,24,2,11,34,11,15
047759a0,Ibrahima Kebe,22,Girona,La Liga,0.1,2000,MF,1,0,1,0,"",0,0,0,0,1,1,0,0,2,1,1
0480ebc7,Elijah Adebayo,25,Luton Town,Premier League,15.8,1998,FW,11,2,13,1,8.3,12,11,25,0,6,4,3,1,10,0,1
048a1cbc,Raphael Guerreiro,29,Bayern Munich,Bundesliga,13.2,1993,"DF,MF",6,1,7,9,60.0,15,6,5,1,15,19,4,6,34,9,16
049751d7,Andras Schafer,24,Union Berlin,Bundesliga,13.5,1999,MF,21,4,25,11,55.0,20,9,25,0,20,29,5,9,49,15,16
049a888d,Mykhailo Mudryk,22,Chelsea,Premier League,17.5,2001,FW,13,1,14,10,31.3,32,22,9,0,9,21,5,9,30,7,12
04ac78d2,Bamo Meite,21,Lorient,Ligue 1,1.6,2001,DF,1,2,3,0,0.0,1,1,9,0,3,2,0,2,5,0,1
04bb2b06,Ibrahima Kone,24,Lorient,Ligue 1,0.4,1999,FW,0,0,0,0,0.0,1,1,0,0,0,0,0,0,0,0,0
04c4edc1,Gennaro Borrelli,23,Frosinone,Serie A,0.3,2000,FW,0,0,0,0,"",0,0,0,0,0,0,0,0,0,0,0
04df29a5,Lorenzo Colombo,21,Monza,Serie A,15.1,2002,FW,13,5,18,8,57.1,14,6,14,0,0,17,5,3,17,9,12
04e17fd5,Youssef En-Nesyri,26,Sevilla,La Liga,28.6,1997,FW,8,1,9,0,0.0,10,10,29,1,7,10,3,3,17,4,7
04e531b6,Pablo Torre,20,Girona,La Liga,7.8,2003,"MF,FW",8,2,10,4,40.0,10,6,6,1,4,5,0,0,9,5,2
0512a60a,Ismael Doukoure,20,Strasbourg,Ligue 1,18.4,2003,"MF,DF",12,7,19,13,61.9,21,8,29,2,19,23,2,7,42,14,16
05439de2,David Alaba,31,Real Madrid,La Liga,12.8,1992,DF,3,7,10,4,50.0,8,4,34,0,15,13,1,7,28,5,9
0545a08e,Walid Cheddira,25,Frosinone,Serie A,23.6,1998,FW,5,1,6,4,50.0,8,4,10,0,5,12,3,1,17,8,7
054849d2,Iago,26,Augsburg,Bundesliga,18.0,1997,DF,31,8,39,17,51.5,33,16,43,0,18,36,4,22,54,10,17
056269d7,Oscar Mingueza,24,Celta Vigo,La Liga,33.3,1999,"DF,MF",31,7,38,37,46.3,80,43,49,2,17,62,7,44,79,11,38
0562b7f1,Odsonne Edouard,25,Crystal Palace,Premier League,17.3,1998,"FW,MF",16,1,17,4,21.1,19,15,19,0,6,24,8,8,30,8,12
056a8552,Shio Fukuda,19,Gladbach,Bundesliga,0.4,2004,"FW,MF",0,0,0,1,50.0,2,1,0,0,1,2,0,1,3,1,0
056d2d95,Christopher Trimmel,36,Union Berlin,Bundesliga,18.3,1987,DF,13,3,16,13,39.4,33,20,57,0,13,23,1,12,36,10,15
059a83b8,Therence Koudou,18,Reims,Ligue 1,3.5,2004,DF,1,3,4,0,0.0,2,2,9,0,4,2,0,1,6,1,2
05ba9d7c,Tanguy Coulibaly,22,Montpellier,Ligue 1,6.9,2001,"FW,MF",10,1,11,4,44.4,9,5,2,0,2,13,1,8,15,4,11
05d548d8,Mats Hummels,34,Dortmund,Bundesliga,17.6,1988,DF,22,11,33,30,56.6,53,23,82,0,33,52,6,34,85,12,34
05e8ca6d,Cameron Archer,22,Aston Villa,Premier League,0.1,2001,MF,0,0,0,0,"",0,0,0,0,0,0,0,0,0,0,0
05f99a4a,Jonathan Burkardt,23,Mainz 05,Bundesliga,17.1,2000,"FW,MF",13,3,16,4,36.4,11,7,2,0,3,12,4,2,15,6,8
061266cd,Darlin Yongwa,22,Lorient,Ligue 1,12.9,2000,DF,12,2,14,14,56.0,25,11,36,0,15,30,2,17,45,11,23
061e8e23,Maximilian Philipp,29,Freiburg,Bundesliga,3.6,1994,"FW,MF",7,0,7,1,16.7,6,5,3,0,1,8,0,4,9,4,5
0630eb63,Nemanja Radonjic,27,Mallorca,La Liga,3.9,1996,"MF,DF",2,0,2,1,25.0,4,3,3,0,3,4,0,1,7,3,2
065dc209,Terem Moffi,24,Nice,Ligue 1,21.7,1999,FW,13,1,14,3,25.0,12,9,15,0,3,7,2,0,10,5,4
068f4dec,Benat Turrientes,21,Real Sociedad,La Liga,18.7,2002,MF,11,8,19,13,43.3,30,17,17,0,6,31,5,6,37,20,17
06a1d642,Mohammed Daramy,21,Reims,Ligue 1,18.3,2002,"FW,MF",4,1,5,6,37.5,16,10,4,0,4,10,2,4,14,4,9
06b08c45,Jacopo Fazzini,20,Empoli,Serie A,13.7,2003,MF,18,3,21,30,56.6,53,23,18,0,12,49,9,27,61,13,25
06c48679,Jonathan Gradit,30,Lens,Ligue 1,23.5,1992,DF,13,17,30,19,54.3,35,16,61,0,37,32,3,15,69,14,20
06df8256,Benoit Badiashile,22,Chelsea,Premier League,14.9,2001,DF,7,14,21,9,64.3,14,5,66,2,18,21,0,12,39,9,15
06efa9dc,Sergio Akieme,25,Reims,Ligue 1,9.1,1997,DF,6,3,9,8,72.7,11,3,25,0,10,11,2,6,21,3,5
0704d719,Mateus Lusuardi,19,Frosinone,Serie A,2.4,2004,DF,2,2,4,1,33.3,3,2,8,0,4,2,0,1,6,1,1
070a3904,Sergi Darder,29,Mallorca,La Liga,24.0,1993,MF,16,4,20,12,38.7,31,19,16,0,16,39,5,13,55,21,26
0728bebe,Gaetano Castrovilli,26,Fiorentina,Serie A,4.1,1997,"FW,MF",4,0,4,1,12.5,8,7,3,0,2,3,0,1,5,2,2
075fe5a3,Srdan Babic,27,Almería,La Liga,1.0,1996,DF,0,1,1,1,100.0,1,0,2,0,0,2,0,0,2,2,2
077faf72,Matheus Franca,19,Crystal Palace,Premier League,2.6,2004,"MF,FW",4,0,4,1,14.3,7,6,1,0,1,3,0,2,4,1,3
07802f7f,Danny Ings,31,West Ham,Premier League,4.5,1992,FW,3,1,4,4,30.8,13,9,7,0,3,6,0,0,9,6,2
07c7eb0c,Anthony Losilla,37,Bochum,Bundesliga,28.6,1986,MF,29,8,37,23,45.1,51,28,51,0,25,63,8,15,88,40,37
07d3bfec,Tom Bischof,18,Hoffenheim,Bundesliga,2.0,2005,"MF,FW",3,0,3,2,22.2,9,7,2,0,1,8,1,6,9,1,4
07d65234,Anass Zaroury,22,Burnley,Premier League,1.7,2000,"FW,MF",2,0,2,0,0.0,4,4,1,1,0,1,0,1,1,0,0
0821331c,Mattia Bani,29,Genoa,Serie A,25.6,1993,DF,20,31,51,11,50.0,22,11,116,1,22,26,1,18,48,7,10
08391d76,Leonidas Stergiou,21,Stuttgart,Bundesliga,6.6,2002,DF,7,1,8,9,69.2,13,4,13,0,5,15,1,7,20,7,8
08511d65,Sergio Ramos,37,Sevilla,La Liga,28.0,1986,DF,5,30,35,27,67.5,40,13,156,0,41,45,2,32,86,11,30
08593525,Diadie Samassekou,27,Hoffenheim,Bundesliga,0.0,1996,MF,0,0,0,0,"",0,0,0,0,1,0,0,0,1,0,0
08aa9cd1,Andrea Pinamonti,24,Sassuolo,Serie A,34.2,1999,FW,17,2,19,5,22.7,22,17,40,0,1,13,6,1,14,6,8
08eb3b58,Matias Vina,25,Sassuolo,Serie A,11.3,1997,DF,10,2,12,20,55.6,36,16,34,0,9,34,5,22,43,7,21
0911b4fc,Tim Drexler,18,Hoffenheim,Bundesliga,6.4,2005,DF,4,8,12,8,47.1,17,9,14,0,8,16,0,12,24,4,9
0917188a,Pontus Almqvist,24,Lecce,Serie A,23.4,1999,"FW,MF",19,2,21,23,45.1,51,28,10,0,14,45,7,16,59,22,29
091c86e2,Felix Nmecha,22,Dortmund,Bundesliga,11.3,2000,MF,13,5,18,11,50.0,22,11,19,0,11,19,4,7,30,8,13
09507ffa,Aleksandar Radovanovic,29,Almería,La Liga,6.3,1993,DF,0,8,8,6,100.0,6,0,48,0,11,8,0,7,19,1,7
0959c2a2,Federico Valverde,25,Real Madrid,La Liga,32.3,1998,MF,37,2,39,24,57.1,42,18,40,0,43,47,12,22,90,13,34
0967845b,Fabiano Parisi,22,Fiorentina,Serie A,16.2,2000,DF,16,5,21,15,57.7,26,11,26,0,17,30,7,11,47,12,15
09899de8,Simone Romagnoli,33,Frosinone,Serie A,30.2,1990,DF,15,36,51,15,75.0,20,5,147,0,29,35,1,23,64,11,15
099a2de5,Giuseppe Caso,24,Frosinone,Serie A,4.6,1998,"FW,MF",0,0,0,2,66.7,3,1,0,0,0,4,2,2,4,0,3
0a084b35,Josip Juranovic,27,Union Berlin,Bundesliga,14.4,1995,DF,14,3,17,10,47.6,21,11,27,1,12,20,2,11,32,7,14
0a3d6d2b,Chris Richards,23,Crystal Palace,Premier League,23.3,2000,"DF,MF",20,12,32,20,66.7,30,10,109,0,27,46,3,21,73,22,28
0a3f6cde,Christopher Antwi-Adjei,29,Bochum,Bundesliga,13.5,1994,"FW,MF",11,2,13,12,54.5,22,10,11,1,2,21,5,10,23,6,12
0a447501,Antonio Sanabria,27,Torino,Serie A,23.7,1996,"FW,MF",6,1,7,4,44.4,9,5,12,0,6,18,4,5,24,9,15
0a483542,Giorgos Kyriakopoulos,27,Monza,Serie A,19.0,1996,DF,17,1,18,11,45.8,24,13,28,0,13,19,0,16,32,3,10
0a69de7b,Kike Salas,21,Sevilla,La Liga,17.8,2002,DF,11,14,25,22,61.1,36,14,91,1,26,41,3,26,67,12,23
0a89e877,Benjamin Henrichs,26,RB Leipzig,Bundesliga,28.1,1997,DF,45,4,49,27,46.6,58,31,37,0,33,68,10,32,101,26,39
0ab1f153,Juan Cuadrado,35,Inter,Serie A,3.0,1988,DF,5,1,6,3,60.0,5,2,2,0,1,4,0,2,5,2,3
0abc51f2,Jorge Cuenca,23,Villarreal,La Liga,21.8,1999,DF,11,15,26,19,63.3,30,11,114,0,21,42,6,26,63,10,29
0ad53bdc,Milos Kerkez,19,Bournemouth,Premier League,21.9,2003,DF,20,11,31,30,71.4,42,12,60,2,20,47,3,31,67,13,26
0ae4e09a,Roger Marti,32,Cádiz,La Liga,15.1,1991,FW,15,1,16,2,28.6,7,5,4,0,7,12,2,1,19,9,6
0af4dcf0,Cedric Bakambu,32,Betis,La Liga,2.2,1991,FW,2,0,2,0,"",0,0,0,0,0,1,0,0,1,1,0
0b33f6ad,Mohammed Salisu,24,Monaco,Ligue 1,11.5,1999,DF,9,12,21,17,65.4,26,9,44,0,22,27,3,11,49,13,12
0b4f388a,Breel Embolo,26,Monaco,Ligue 1,2.0,1997,FW,1,0,1,1,25.0,4,3,2,0,1,3,1,0,4,2,3
0b5a292a,Mario Rui,32,Napoli,Serie A,13.4,1991,DF,15,2,17,14,66.7,21,7,19,0,15,27,5,17,42,5,15
0b6911e4,Jeremy Sebas,20,Strasbourg,Ligue 1,4.4,2003,"FW,MF",2,1,3,3,60.0,5,2,1,0,1,7,2,2,8,3,1
0ba976e4,Ansu Fati,20,Barcelona,La Liga,0.6,2002,"MF,FW",0,0,0,0,0.0,1,1,0,0,0,0,0,0,0,0,0
0be276c6,Norbert Gyomber,31,Salernitana,Serie A,19.6,1992,DF,10,23,33,20,76.9,26,6,77,2,23,36,0,30,59,6,18
0be95d34,Romain Del Castillo,27,Brest,Ligue 1,27.7,1996,FW,32,1,33,18,25.7,70,52,8,0,9,46,14,14,55,18,29
0bfca6a1,Quentin Merlin,21,Nantes,Ligue 1,14.3,2002,DF,21,1,22,16,64.0,25,9,22,0,18,29,2,15,47,12,20
0c61c77c,Dodi Lukebakio,25,Sevilla,La Liga,12.5,1997,"FW,MF",7,2,9,1,16.7,6,5,5,0,2,5,1,2,7,2,2
0c7a48f8,Piero Hincapie,21,Leverkusen,Bundesliga,16.5,2002,DF,11,7,18,13,76.5,17,4,43,0,13,35,4,14,48,17,22
0c7b1c91,Lucas Michal,18,Monaco,Ligue 1,0.1,2005,FW,0,0,0,0,"",0,0,0,0,0,0,0,0,0,0,0
0cadc46d,Vedat Muriqi,29,Mallorca,La Liga,25.9,1994,FW,7,4,11,2,14.3,14,12,26,0,6,11,4,4,17,3,6
0cb29e91,Njegos Petrovic,24,Granada,La Liga,1.7,1999,"MF,FW",2,0,2,2,66.7,3,1,3,0,1,5,0,4,6,1,2
0cbc8baa,Jean-Kevin Duverne,26,Nantes,Ligue 1,15.0,1997,DF,12,5,17,18,40.9,44,26,34,0,18,37,4,16,55,17,19
0cbe584d,Filip Stojilkovic,23,Darmstadt 98,Bundesliga,1.7,2000,"FW,MF",0,0,0,0,"",0,0,1,0,0,1,1,0,1,0,1
0cbf4c54,Norman Theuerkauf,36,Heidenheim,Bundesliga,14.0,1987,"MF,DF",10,6,16,13,59.1,22,9,21,0,14,24,4,13,38,7,16
0cc5f4a5,Lukas Nmecha,24,Wolfsburg,Bundesliga,0.5,1998,FW,1,0,1,0,"",0,0,0,0,0,1,1,0,1,0,1
0ccac09c,Stefano Sabelli,30,Genoa,Serie A,27.0,1993,DF,21,6,27,15,32.6,46,31,35,0,23,50,3,28,73,19,24
0cd31129,Brennan Johnson,22,"Nott'ham Forest",Premier League,2.6,2001,"FW,MF",3,1,4,2,50.0,4,2,0,0,0,4,2,1,4,1,1
0cf465f2,Kaio Jorge,21,Frosinone,Serie A,9.0,2002,FW,6,0,6,3,75.0,4,1,0,0,1,6,5,0,7,1,4
0cf778df,Chris Fuhrich,25,Stuttgart,Bundesliga,28.5,1998,"FW,MF",31,0,31,16,43.2,37,21,7,0,7,30,10,6,37,14,19
0d077b88,Mehdi Bourabia,31,Frosinone,Serie A,2.2,1991,MF,3,0,3,2,50.0,4,2,4,0,0,5,0,1,5,4,4
0d7b6576,Elye Wahi,20,Lens,Ligue 1,18.8,2003,FW,4,1,5,2,20.0,10,8,3,0,3,6,2,1,9,3,4
0d82903c,Alex Sandro,32,Juventus,Serie A,8.0,1991,DF,6,7,13,4,80.0,5,1,23,0,15,13,0,7,28,6,7
0d9b2d31,Pedri,20,Barcelona,La Liga,16.4,2002,"MF,FW",24,3,27,8,29.6,27,19,10,0,14,33,4,16,47,13,24
0da3d7ab,Mathis Lambourde,17,Rennes,Ligue 1,0.1,2006,FW,1,0,1,0,0.0,1,1,1,0,0,0,0,0,0,0,0
0db169ae,Sandro Tonali,23,Newcastle Utd,Premier League,4.9,2000,MF,3,0,3,3,33.3,9,6,4,0,2,7,1,4,9,2,7
0db5d2c8,Mathias Jorgensen,33,Brentford,Premier League,12.1,1990,DF,4,5,9,11,57.9,19,8,40,0,12,17,1,15,29,1,12
0def2376,Warren Bondo,19,Monza,Serie A,16.4,2003,MF,10,3,13,13,76.5,17,4,13,0,6,29,3,16,35,10,22
0e006cae,Kjell-Arik Watjen,17,Dortmund,Bundesliga,1.2,2006,"MF,FW",0,1,1,2,40.0,5,3,3,0,0,3,0,2,3,1,2
0e0102eb,Omar Marmoush,24,Eint Frankfurt,Bundesliga,25.6,1999,"FW,MF",13,0,13,6,37.5,16,10,7,0,11,21,6,7,32,8,11
0e46fa2f,Matthis Abline,20,Nantes,Ligue 1,11.6,2003,FW,3,0,3,3,37.5,8,5,5,0,3,9,2,4,12,3,4
0e4fef6e,Lucas Torro,29,Osasuna,La Liga,19.9,1994,MF,8,2,10,11,39.3,28,17,37,0,33,25,6,11,58,8,15
0e6bc38c,Eric Maxim Choupo-Moting,34,Bayern Munich,Bundesliga,8.0,1989,"MF,FW",5,0,5,6,42.9,14,8,7,0,7,17,4,8,24,5,12
0e8d7b6c,Ayman Kari,18,Lorient,Ligue 1,9.9,2004,MF,17,2,19,12,63.2,19,7,9,1,6,18,0,9,24,9,14
0ed063d6,Yasser Larouci,22,Sheffield Utd,Premier League,5.9,2001,DF,5,1,6,10,71.4,14,4,20,1,7,17,2,10,24,5,9
0ed60738,Senne Lynen,24,Werder Bremen,Bundesliga,20.0,1999,MF,33,8,41,30,42.9,70,40,56,0,41,64,4,33,105,27,38
0ee6ea6a,Grant Ranos,20,Gladbach,Bundesliga,0.5,2003,"MF,FW",0,0,0,0,"",0,0,0,0,0,1,1,0,1,0,0
0ef89a37,Philippe Coutinho,31,Aston Villa,Premier League,0.3,1992,"MF,FW",0,0,0,0,0.0,1,1,0,0,0,0,0,0,0,0,0
0f134faf,Mathias Jensen,27,Brentford,Premier League,24.5,1996,MF,35,6,41,26,27.4,95,69,25,1,23,54,7,25,77,22,32
0f26ffd7,Copete,23,Mallorca,La Liga,14.8,1999,DF,6,6,12,30,69.8,43,13,47,1,32,45,1,27,77,17,27
0f59a7bf,Anton Stach,24,Mainz 05,Bundesliga,1.9,1998,MF,5,0,5,2,50.0,4,2,5,0,2,3,1,2,5,0,0
0f7533cd,Bobby Reid,30,Fulham,Premier League,15.8,1993,FW,22,2,24,4,25.0,16,12,14,0,5,22,2,5,27,15,14
0f8418aa,Ibrahima Sissoko,25,Strasbourg,Ligue 1,18.2,1997,MF,13,8,21,23,76.7,30,7,30,0,19,47,9,13,66,25,33
0f86995c,Hianga Mananga Mbock,23,Brest,Ligue 1,0.1,1999,"MF,FW",0,0,0,1,50.0,2,1,0,0,1,1,1,0,2,0,0
0fbecd11,Dominik Kohr,29,Mainz 05,Bundesliga,24.3,1994,"DF,MF",21,6,27,36,63.2,57,21,58,0,43,65,4,36,108,25,42
0fdcef0e,Kristjan Asllani,21,Inter,Serie A,8.7,2002,MF,6,3,9,2,18.2,11,9,8,0,11,7,0,3,18,4,2
0fee6bda,Martin Erlic,25,Sassuolo,Serie A,29.1,1998,DF,15,16,31,20,66.7,30,10,128,1,28,37,3,26,65,8,22
1025db8e,Jeffrey Gouweleeuw,32,Augsburg,Bundesliga,28.8,1991,DF,20,24,44,16,64.0,25,9,108,0,35,35,5,13,70,17,23
102c9665,Alexsandro Ribeiro,23,Lille,Ligue 1,24.7,1999,DF,10,15,25,16,51.6,31,15,116,5,35,32,0,24,67,8,22
102e2599,Tommaso Baldanzi,20,Roma,Serie A,5.8,2003,"FW,MF",2,0,2,1,100.0,1,0,4,0,0,9,2,3,9,4,5
104d0bb8,Alex Scott,19,Bournemouth,Premier League,11.3,2003,MF,10,4,14,12,42.9,28,16,18,2,12,24,6,8,36,10,15
10549b49,Sardar Azmoun,28,Roma,Serie A,6.5,1995,"FW,MF",3,1,4,4,50.0,8,4,6,1,3,8,1,2,11,5,5
106c142c,Jesus Vazquez,20,Valencia,La Liga,8.0,2003,"DF,MF",13,4,17,10,62.5,16,6,24,0,3,24,3,13,27,8,12
10745192,Jamie Bynoe-Gittens,18,Dortmund,Bundesliga,11.8,2004,"FW,MF",9,2,11,2,11.8,17,15,7,0,4,14,1,6,18,7,7
1079c685,Alberto Cerri,27,Empoli,Serie A,6.1,1996,FW,2,1,3,2,40.0,5,3,7,0,3,3,1,1,6,1,3
10876d02,Marvin Mehlem,25,Darmstadt 98,Bundesliga,16.5,1997,MF,19,2,21,11,40.7,27,16,15,0,33,28,4,10,61,14,21
10a10454,Joe Rothwell,28,Bournemouth,Premier League,4.3,1995,MF,2,2,4,2,25.0,8,6,2,0,3,7,1,4,10,2,2
10cb48b7,Daiki Hashioka,24,Luton Town,Premier League,6.6,1999,DF,5,7,12,5,45.5,11,6,20,0,8,11,1,6,19,4,5
10cff752,Aron Donnum,25,Toulouse,Ligue 1,17.7,1998,"FW,MF",13,0,13,7,31.8,22,15,16,1,8,16,5,3,24,8,10
10e51236,Abou Lo,23,Metz,Ligue 1,2.2,2000,"MF,DF",3,2,5,1,25.0,4,3,8,0,4,3,0,2,7,1,1
10e7f486,Rogerio,25,Wolfsburg,Bundesliga,10.1,1998,DF,11,5,16,10,71.4,14,4,23,1,5,14,2,7,19,5,6
10f0fdd3,Jean-Ricner Bellegarde,25,Strasbourg,Ligue 1,3.0,1998,"MF,FW",4,0,4,3,50.0,6,3,0,0,4,5,0,3,9,2,3
112521d1,Adria Pedrosa,25,Sevilla,La Liga,19.5,1998,DF,20,6,26,23,67.6,34,11,54,0,15,46,4,28,61,14,26
1137759d,Sergi Canos,26,Valencia,La Liga,13.7,1997,"MF,FW",12,2,14,10,41.7,24,14,9,0,11,23,5,7,34,11,13
11407d95,Marvin Pieringer,23,Heidenheim,Bundesliga,16.8,1999,"MF,FW",24,4,28,8,40.0,20,12,21,0,12,19,3,5,31,11,12
114bbdee,Loic Bade,23,Sevilla,La Liga,25.3,2000,DF,8,15,23,30,61.2,49,19,116,2,38,65,0,53,103,12,41
116c35df,Donyell Malen,24,Dortmund,Bundesliga,19.8,1999,"FW,MF",7,4,11,2,33.3,6,4,8,0,2,11,3,5,13,3,7
119b9a8e,Aymeric Laporte,29,Manchester City,Premier League,0.1,1994,DF,0,1,1,0,"",0,0,1,0,0,0,0,0,0,0,0
11b9265b,Alberto Moreno,31,Villarreal,La Liga,16.5,1992,DF,10,2,12,10,33.3,30,20,33,0,24,31,2,19,55,10,21
11fd2b75,Omar Mascarell,30,Mallorca,La Liga,17.5,1993,MF,16,8,24,18,51.4,35,17,30,1,31,33,0,16,64,17,16
1238a3f9,Davie Selke,28,Köln,Bundesliga,14.1,1995,FW,2,3,5,0,0.0,2,2,20,0,0,4,0,1,4,3,2
123d2733,George Earthy,18,West Ham,Premier League,0.4,2004,FW,0,0,0,0,0.0,1,1,0,0,1,0,0,0,1,0,0
1265a93a,Reece James,23,Chelsea,Premier League,4.7,1999,DF,0,4,4,8,80.0,10,2,7,1,3,14,1,10,17,3,9
12806697,Isak Hien,24,Atalanta,Serie A,10.4,1999,DF,7,5,12,7,46.7,15,8,33,0,14,18,0,8,32,10,12
1282939a,Jhon Solis,18,Girona,La Liga,4.3,2004,MF,5,3,8,4,33.3,12,8,7,1,8,10,1,4,18,5,8
129af0db,Alvaro Morata,30,Atlético Madrid,La Liga,21.2,1992,FW,15,3,18,3,60.0,5,2,26,0,1,16,5,4,17,7,10
12a4e38c,Etienne Youte Kinkoue,21,Le Havre,Ligue 1,21.6,2002,DF,5,16,21,7,63.6,11,4,104,0,44,15,0,13,59,2,9
12c35abe,Jens Petter Hauge,23,Eint Frankfurt,Bundesliga,1.6,1999,"MF,FW",4,1,5,2,28.6,7,5,1,0,0,2,1,1,2,0,1
12c50af5,Denis Suarez,29,Villarreal,La Liga,1.5,1994,"MF,FW",0,2,2,0,0.0,2,2,4,0,0,0,0,0,0,0,0
12de1b0d,Diego Moreira,18,Lyon,Ligue 1,3.0,2004,"FW,MF",3,0,3,0,0.0,3,3,5,0,2,0,0,0,2,0,0
12f9a649,Simon Ebonog,18,Le Havre,Ligue 1,0.2,2004,MF,0,1,1,1,100.0,1,0,1,0,0,1,0,0,1,1,1
130a7a3f,Samu Castillejo,28,Sassuolo,Serie A,6.0,1995,"FW,MF",15,1,16,7,36.8,19,12,3,0,1,12,2,5,13,5,10
13203c45,Jerome Roussillon,30,Union Berlin,Bundesliga,8.4,1993,DF,9,4,13,8,66.7,12,4,26,0,5,16,3,6,21,7,9
13210854,Olivier Deman,23,Werder Bremen,Bundesliga,15.2,2000,DF,16,8,24,18,47.4,38,20,49,1,14,28,3,21,42,4,15
132ac341,Aridane Hernandez,34,Rayo Vallecano,La Liga,18.8,1989,DF,5,14,19,4,36.4,11,7,98,1,14,10,1,5,24,4,8
133d2aa5,Aboubacar Ali,17,Strasbourg,Ligue 1,1.4,2006,"MF,FW",1,0,1,0,"",0,0,2,0,1,2,0,0,3,2,0
133faa84,Marcao,27,Sevilla,La Liga,3.9,1996,DF,2,6,8,6,60.0,10,4,11,1,4,9,0,5,13,4,6
13b9e2fb,Lorenzo Amatucci,19,Fiorentina,Serie A,0.2,2004,MF,0,0,0,0,"",0,0,0,0,0,0,0,0,0,0,0
13d23b29,Antonios Papadopoulos,23,Dortmund,Bundesliga,1.3,1999,DF,1,2,3,6,85.7,7,1,7,0,2,6,0,6,8,0,3
13ddc856,Takuma Asano,28,Bochum,Bundesliga,22.1,1994,"FW,MF",14,3,17,7,30.4,23,16,11,0,4,17,6,2,21,9,6
13e827f8,Joel Asoro,24,Metz,Ligue 1,9.4,1999,"FW,MF",6,1,7,3,30.0,10,7,9,0,6,13,0,7,19,6,9
13fe7b69,Jamie Leweling,22,Stuttgart,Bundesliga,16.9,2001,"FW,MF",20,1,21,5,29.4,17,12,13,0,5,18,8,4,23,6,10
144e8717,Christoph Klarer,23,Darmstadt 98,Bundesliga,26.2,2000,DF,11,20,31,24,66.7,36,12,94,1,21,37,3,30,58,4,22
148e136f,Remy Cabella,33,Lille,Ligue 1,16.4,1990,"FW,MF",32,0,32,20,37.0,54,34,5,0,5,54,15,19,59,20,36
149c5f5d,Giuseppe Pezzella,25,Empoli,Serie A,12.1,1997,DF,11,6,17,20,71.4,28,8,35,0,2,25,1,19,27,5,14
14a7af33,Christian Gross,34,Werder Bremen,Bundesliga,8.9,1989,"DF,MF",11,6,17,11,44.0,25,14,28,1,13,21,1,11,34,9,16
14aac43e,Fares Ghedjemis,20,Frosinone,Serie A,2.0,2002,"FW,MF",2,0,2,0,0.0,2,2,2,0,1,2,1,1,3,0,0
14b09c41,Jordy Makengo,21,Freiburg,Bundesliga,11.4,2001,DF,12,4,16,6,60.0,10,4,37,0,11,17,1,11,28,5,11
14b8fcdf,Daniele Rugani,29,Juventus,Serie A,13.2,1994,DF,7,4,11,4,80.0,5,1,42,0,9,11,1,7,20,3,9
15413fa5,Salih Ozcan,25,Dortmund,Bundesliga,13.2,1998,MF,25,3,28,10,55.6,18,8,18,1,17,20,1,11,37,8,12
1544f145,Jacob Ramsey,22,Aston Villa,Premier League,9.5,2001,"FW,MF",13,2,15,5,33.3,15,10,8,0,3,16,3,7,19,6,8
1545cf15,Houboulang Mendes,25,Almería,La Liga,4.4,1998,DF,2,2,4,8,50.0,16,8,17,1,1,16,0,11,17,5,13
15937e17,Eray Comert,25,Nantes,Ligue 1,22.2,1998,DF,17,18,35,28,73.7,38,10,77,1,36,42,1,28,78,13,28
15944afd,Eliot Matazo,21,Monaco,Ligue 1,1.1,2002,MF,0,1,1,2,50.0,4,2,0,0,3,3,0,0,6,3,1
1598599e,Nampalys Mendy,31,Lens,Ligue 1,11.7,1992,MF,7,4,11,16,80.0,20,4,14,1,14,29,6,10,43,13,18
15ab5a2b,Julian Alvarez,23,Manchester City,Premier League,29.4,2000,"MF,FW",30,0,30,8,25.0,32,24,14,1,2,24,11,5,26,8,13
15b287da,Daichi Kamada,26,Lazio,Serie A,17.2,1996,MF,19,5,24,28,53.8,52,24,7,0,18,53,9,22,71,22,36
15d0c248,Luiz Felipe,26,Betis,La Liga,4.0,1997,DF,6,4,10,4,80.0,5,1,16,0,4,7,0,5,11,2,3
15ea812b,James Tarkowski,30,Everton,Premier League,38.0,1992,DF,26,56,82,27,56.3,48,21,191,2,56,61,1,46,117,14,42
15f24fe7,Sasa Kalajdzic,26,Eint Frankfurt,Bundesliga,3.6,1997,FW,0,2,2,0,"",0,0,6,0,2,2,0,0,4,2,2
15f3ec41,Callum Hudson-Odoi,22,"Nott'ham Forest",Premier League,20.6,2000,"FW,MF",15,1,16,7,25.0,28,21,12,1,7,18,9,4,25,5,8
15fd5593,Davy Klaassen,30,Inter,Serie A,2.3,1993,MF,4,1,5,1,33.3,3,2,4,0,3,4,0,0,7,4,2
1609700b,Sofiane Sidi Ali,28,Marseille,Ligue 1,0.2,1995,MF,1,0,1,1,50.0,2,1,0,0,2,2,0,0,4,2,0
16264a81,Moises Caicedo,21,Chelsea,Premier League,31.8,2001,MF,34,25,59,36,60.0,60,24,44,4,37,91,11,38,128,42,46
162efffd,Rodrigo De Paul,29,Atlético Madrid,La Liga,23.1,1994,MF,27,1,28,15,39.5,38,23,15,2,11,31,6,11,42,14,21
1633fc8a,Juanpe,32,Girona,La Liga,8.3,1991,DF,6,11,17,9,90.0,10,1,50,1,7,11,0,8,18,3,8
16463a79,Demba Seck,22,Frosinone,Serie A,3.3,2001,"FW,MF",3,0,3,4,80.0,5,1,1,0,1,7,2,2,8,3,4
16657b95,Bryan Cristante,28,Roma,Serie A,36.5,1995,"MF,DF",30,6,36,28,56.0,50,22,55,2,25,72,11,33,97,28,41
169fd162,Hwang Hee-chan,27,Wolves,Premier League,23.5,1996,"FW,MF",18,1,19,9,37.5,24,15,9,0,10,20,1,11,30,8,10
16aa3654,Takefusa Kubo,22,Real Sociedad,La Liga,23.9,2001,"FW,MF",19,2,21,9,39.1,23,14,8,1,11,26,5,15,37,6,17
16aa7d4c,Brendan Chardonnet,28,Brest,Ligue 1,33.0,1994,DF,24,34,58,32,50.8,63,31,139,3,53,57,2,33,110,22,34
16bb656a,Pawel Dawidowicz,28,Hellas Verona,Serie A,23.8,1995,DF,8,9,17,17,58.6,29,12,114,1,24,53,2,33,77,18,30
16ceb862,Olivier Giroud,36,Milan,Serie A,26.3,1986,FW,11,3,14,2,14.3,14,12,22,0,6,17,5,6,23,6,11
16e9d0ea,Alex Moreno,30,Aston Villa,Premier League,11.5,1993,DF,9,2,11,12,63.2,19,7,37,0,13,18,0,18,31,0,12
16ec501b,Abdellah Raihani,19,Atlético Madrid,La Liga,0.1,2004,FW,0,0,0,0,0.0,1,1,0,0,0,0,0,0,0,0,0
1704b0b8,Murillo,21,"Nott'ham Forest",Premier League,31.0,2002,DF,17,24,41,19,57.6,33,14,188,0,37,50,1,36,87,13,31
17370b95,Bernardo,28,Bochum,Bundesliga,32.5,1995,DF,36,30,66,45,65.2,69,24,120,1,55,99,8,56,154,35,58
174f09a6,Ignasi Miquel,30,Granada,La Liga,33.2,1992,DF,16,16,32,23,57.5,40,17,132,4,45,47,2,39,92,6,30
175ece4c,Iker Munoz,20,Osasuna,La Liga,20.6,2002,MF,11,5,16,15,48.4,31,16,50,0,11,32,2,13,43,17,18
17695062,Emile Smith Rowe,23,Arsenal,Premier League,3.9,2000,MF,2,1,3,2,50.0,4,2,1,0,3,4,0,2,7,2,1
178018f9,Fabian Nurnberger,24,Darmstadt 98,Bundesliga,16.8,1999,"DF,MF",10,1,11,22,53.7,41,19,26,0,17,29,1,22,46,6,22
1780bb4a,Aaron Hickey,21,Brentford,Premier League,7.9,2002,DF,4,3,7,7,100.0,7,0,10,0,3,16,4,9,19,3,9
178ae8f8,Diogo Jota,26,Liverpool,Premier League,12.7,1996,FW,8,1,9,10,43.5,23,13,4,0,7,23,4,6,30,13,13
17bb562c,Arouna Sangante,21,Le Havre,Ligue 1,29.9,2002,DF,17,18,35,24,60.0,40,16,93,2,66,53,3,27,119,23,33
17e1261b,Neil El Aynaoui,22,Lens,Ligue 1,17.4,2001,MF,14,6,20,20,43.5,46,26,21,1,32,37,4,13,69,20,20
184fe4b2,Williot Swedberg,19,Celta Vigo,La Liga,4.9,2004,"FW,MF",10,1,11,5,62.5,8,3,4,0,0,9,0,3,9,6,4
18950a80,Marco Pellegrino,"",Milan,Serie A,0.8,,DF,0,1,1,0,0.0,2,2,2,0,1,1,1,0,2,0,1
18abe173,Joseph Aidoo,27,Celta Vigo,La Liga,4.5,1995,DF,2,1,3,4,50.0,8,4,28,0,4,8,0,6,12,2,3
18b896d6,Antonio Rudiger,30,Real Madrid,La Liga,30.1,1993,DF,7,20,27,16,80.0,20,4,89,0,11,26,4,18,37,4,15
18dd3219,Federico Gatti,25,Juventus,Serie A,29.3,1998,DF,11,15,26,19,79.2,24,5,90,1,19,33,1,16,52,16,19
18f0a9f0,Raul,22,Osasuna,La Liga,15.1,2000,FW,8,1,9,2,20.0,10,8,11,0,5,10,4,4,15,2,4
19053e31,Sofiane Diop,23,Nice,Ligue 1,5.5,2000,FW,4,0,4,4,40.0,10,6,3,0,3,8,1,3,11,4,6
1906b842,Mahamadou Diawara,18,Lyon,Ligue 1,4.0,2005,MF,3,1,4,3,27.3,11,8,4,0,4,9,0,4,13,5,6
1944818c,Yan Couto,21,Girona,La Liga,24.9,2002,"DF,FW",12,2,14,20,50.0,40,20,31,1,10,45,6,25,55,14,34
1956a64b,Francesco Camarda,15,Milan,Serie A,0.2,2008,FW,0,0,0,0,0.0,2,2,0,0,0,0,0,0,0,0,0
1956b948,Jim Allevinah,28,Clermont Foot,Ligue 1,20.7,1995,"MF,DF",17,3,20,14,40.0,35,21,30,0,13,30,5,11,43,14,18
1961b2aa,Andre Gomes,30,Everton,Premier League,5.6,1993,"MF,FW",9,1,10,3,23.1,13,10,4,1,3,7,2,2,10,3,4
19709006,Oscar Rodriguez Arnaiz,25,Getafe,La Liga,10.7,1998,"MF,FW",11,1,12,9,60.0,15,6,5,0,5,24,7,2,29,15,13
1971591f,Cody Gakpo,24,Liverpool,Premier League,18.3,1999,"FW,MF",17,4,21,8,32.0,25,17,7,0,14,27,5,8,41,14,17
197640fd,Timothy Castagne,27,Fulham,Premier League,29.3,1995,DF,28,10,38,26,59.1,44,18,69,1,38,49,10,23,87,16,24
19a12bed,Hassane Kamara,29,Udinese,Serie A,24.7,1994,DF,27,2,29,25,65.8,38,13,66,0,26,45,6,26,71,13,32
19a5c0b6,Marciano Tchami,19,Almería,La Liga,0.5,2004,"FW,MF",0,0,0,0,"",0,0,0,0,0,0,0,0,0,0,0
19a967ab,Ansgar Knauff,21,Eint Frankfurt,Bundesliga,23.4,2002,"MF,DF",37,3,40,17,54.8,31,14,15,0,20,43,10,17,63,16,26
19a9cb70,Kaide Gordon,18,Liverpool,Premier League,0.0,2004,FW,0,0,0,0,"",0,0,0,0,0,0,0,0,0,0,0
19b776e9,Ruben Sobrino,31,Cádiz,La Liga,18.3,1992,"MF,FW",24,2,26,22,43.1,51,29,18,0,16,52,8,18,68,26,28
19ba6c6d,Steve Mounie,28,Brest,Ligue 1,19.7,1994,FW,10,3,13,3,27.3,11,8,18,0,2,8,5,0,10,3,7
19c2ffa4,Lamine Camara,19,Metz,Ligue 1,25.1,2004,MF,33,2,35,24,49.0,49,25,34,0,28,62,6,26,90,30,42
19c36442,Luis Milla,28,Getafe,La Liga,23.5,1994,MF,19,1,20,28,59.6,47,19,10,0,32,57,10,19,89,28,33
19cae58d,Gavi,18,Barcelona,La Liga,10.5,2004,"MF,FW",16,3,19,18,50.0,36,18,16,1,8,39,5,20,47,14,21
19f4d211,Jaden Philogene Bidace,21,Aston Villa,Premier League,0.0,2002,FW,0,0,0,0,"",0,0,0,0,0,0,0,0,0,0,0
1a066e69,Maxime Esteve,21,Montpellier,Ligue 1,11.1,2002,DF,4,9,13,10,66.7,15,5,50,0,18,16,0,11,34,5,12
1a2935f6,Dejan Lovren,34,Lyon,Ligue 1,8.0,1989,DF,1,5,6,3,42.9,7,4,37,0,12,9,0,6,21,3,7
1a4b9094,Bouna Sarr,31,Bayern Munich,Bundesliga,1.2,1992,DF,3,0,3,2,100.0,2,0,1,0,0,2,0,1,2,1,0
1a6b7ea4,Pablo Rosario,26,Nice,Ligue 1,22.3,1997,"MF,DF",14,13,27,23,67.6,34,11,39,0,29,36,5,15,65,16,25
1aa84968,Chris Basham,35,Sheffield Utd,Premier League,3.6,1988,"DF,MF",5,4,9,2,22.2,9,7,17,0,5,7,0,4,12,3,2
1ac232b8,Simone Bastoni,26,Empoli,Serie A,8.3,1996,"MF,DF",8,0,8,11,50.0,22,11,18,0,11,22,3,12,33,7,13
1ae836b1,Elvis Rexhbecaj,25,Augsburg,Bundesliga,22.1,1997,MF,25,7,32,18,50.0,36,18,20,0,20,30,3,14,50,13,19
1b2ec72e,Noam Mayoka-Tika,19,Marseille,Ligue 1,0.0,2003,MF,0,0,0,0,"",0,0,0,0,0,0,0,0,0,0,0
1b4be8eb,Jonas Fohrenbach,27,Heidenheim,Bundesliga,31.0,1996,DF,15,19,34,19,52.8,36,17,70,0,31,44,6,24,75,14,24
1b4f1169,Albert Sambi Lokonga,23,Luton Town,Premier League,14.5,1999,MF,10,13,23,17,70.8,24,7,14,0,11,29,3,14,40,12,18
1b84dbe1,Lucas Digne,30,Aston Villa,Premier League,26.8,1993,DF,18,2,20,25,56.8,44,19,67,0,26,47,3,35,73,9,19
1b9728b0,Omari Forson,19,Manchester Utd,Premier League,0.8,2004,FW,0,0,0,1,100.0,1,0,0,0,0,2,0,0,2,2,0
1bacc518,Frenkie de Jong,26,Barcelona,La Liga,18.2,1997,MF,10,8,18,8,42.1,19,11,28,1,14,43,6,14,57,23,26
1bc6135b,Ablie Jallow,24,Metz,Ligue 1,10.2,1998,"MF,FW",4,0,4,3,60.0,5,2,3,0,8,8,3,2,16,3,5
1bda5842,Portu,31,Girona,La Liga,13.2,1992,"MF,FW",8,1,9,3,16.7,18,15,6,0,4,18,5,3,22,10,13
1bf33a9a,Christian Pulisic,24,Milan,Serie A,28.9,1998,"FW,MF",19,1,20,17,56.7,30,13,10,1,10,35,10,14,45,11,26
1bfb6fef,Bafode Diakite,22,Lille,Ligue 1,18.8,2001,DF,8,8,16,24,75.0,32,8,49,1,21,29,2,12,50,15,20
1c59240b,Pep Biel,26,Augsburg,Bundesliga,3.2,1996,"MF,FW",1,1,2,1,33.3,3,2,2,0,2,4,2,0,6,2,3
1c7012b8,Declan Rice,24,Arsenal,Premier League,35.8,1999,MF,26,11,37,32,56.1,57,25,52,0,44,83,8,37,127,38,51
1cadaf34,Roberto Piccoli,22,Lecce,Serie A,15.3,2001,FW,16,1,17,1,25.0,4,3,16,0,4,10,2,3,14,5,6
1cb49278,Andreas Christensen,27,Barcelona,La Liga,22.0,1996,"DF,MF",13,10,23,16,57.1,28,12,41,0,21,23,2,7,44,14,14
1ccd3dae,Peter Federico,21,Valencia,La Liga,7.2,2002,"MF,FW",11,0,11,1,10.0,10,9,10,0,7,5,1,3,12,1,3
1ceeae3e,Luca Garritano,29,Frosinone,Serie A,5.4,1994,"MF,DF",13,0,13,5,33.3,15,10,8,1,4,10,1,7,14,2,5
1d042188,"Dara O'Shea",24,Burnley,Premier League,32.1,1999,DF,11,30,41,11,42.3,26,15,158,2,35,39,3,22,74,14,20
1d1691ad,Alvaro Odriozola,27,Real Sociedad,La Liga,4.4,1995,DF,1,1,2,5,100.0,5,0,7,0,8,9,1,7,17,1,7
1d383c10,Marvin Senaya,22,Strasbourg,Ligue 1,23.8,2001,"DF,MF",27,13,40,42,61.8,68,26,68,0,41,72,9,38,113,25,53
1d45fd81,Marvin Cuni,22,Frosinone,Serie A,5.9,2001,FW,9,1,10,3,75.0,4,1,0,0,1,8,4,1,9,3,3
1d50130f,Iron Gomis,23,Salernitana,Serie A,1.5,1999,MF,2,0,2,0,0.0,1,1,2,0,2,4,0,2,6,2,1
1d5c96f8,Mikkel Desler,28,Toulouse,Ligue 1,17.2,1995,DF,19,13,32,9,52.9,17,8,38,0,19,18,3,8,37,7,12
1d8aa290,Issa Soumare,22,Le Havre,Ligue 1,2.6,2000,"FW,MF",0,0,0,0,0.0,4,4,2,0,0,2,0,2,2,0,0
1d8e9add,Kevin Vogt,31,Union Berlin,Bundesliga,14.7,1991,DF,7,15,22,6,50.0,12,6,72,2,7,10,0,6,17,4,9
1daec722,Marc Cucurella,25,Chelsea,Premier League,19.8,1998,DF,23,13,36,34,53.1,64,30,48,0,22,62,5,36,84,21,38
1dc5a029,Luca Lipani,18,Sassuolo,Serie A,4.3,2005,MF,7,2,9,3,27.3,11,8,7,0,6,9,2,4,15,3,7
1ddbc7ca,Melvin Bard,22,Nice,Ligue 1,29.5,2000,DF,34,12,46,37,58.7,63,26,46,0,42,69,11,28,111,30,38
1df0c0b9,Robert Gumny,25,Augsburg,Bundesliga,5.3,1998,DF,8,5,13,1,20.0,5,4,15,0,7,6,2,1,13,3,5
1df4a109,Lesley Ugochukwu,19,Chelsea,Premier League,3.3,2004,MF,4,2,6,4,40.0,10,6,5,0,1,14,2,4,15,8,10
1e159d70,Yerson Mosquera,22,Villarreal,La Liga,13.7,2001,DF,10,2,12,12,80.0,15,3,65,0,17,27,2,18,44,7,13
1e2057aa,Moritz-Broni Kwarteng,25,Bochum,Bundesliga,3.1,1998,FW,4,0,4,1,14.3,7,6,0,0,2,3,0,0,5,3,0
1e274a0a,Sven Michel,33,Augsburg,Bundesliga,6.5,1990,"FW,MF",1,0,1,2,28.6,7,5,4,0,0,7,4,2,7,1,5
1e37c986,Maximilian Breunig,22,Freiburg,Bundesliga,0.1,2000,FW,1,0,1,0,"",0,0,0,0,0,0,0,0,0,0,0
1e465e70,Sergio Arribas,21,Almería,La Liga,22.7,2001,"MF,FW",19,1,20,14,45.2,31,17,8,1,16,34,1,16,50,17,17
1e52971c,Johann Lepenant,20,Lyon,Ligue 1,2.8,2002,MF,5,0,5,1,12.5,8,7,0,0,4,4,0,2,8,2,3
1e9aa637,Giorgio Scalvini,19,Atalanta,Serie A,28.3,2003,DF,27,17,44,19,47.5,40,21,71,0,59,53,5,29,112,19,33
1ea5f91c,Jakub Jankto,27,Cagliari,Serie A,9.7,1996,"MF,FW",4,1,5,8,40.0,20,12,20,0,5,12,2,9,17,1,9
1f079188,Ruben Pena,32,Osasuna,La Liga,23.2,1991,"DF,FW",29,8,37,20,40.8,49,29,39,3,30,47,7,22,77,18,25
1f2c7b55,Merlin Rohl,21,Freiburg,Bundesliga,16.4,2002,"MF,FW",24,3,27,8,38.1,21,13,22,0,9,21,2,10,30,9,13
1f3afdcb,Odilon Kossonou,22,Leverkusen,Bundesliga,20.1,2001,DF,24,3,27,15,57.7,26,11,43,1,27,30,7,11,57,12,20
1f423a54,Sergio Ruiz,28,Granada,La Liga,27.7,1994,MF,18,6,24,38,45.2,84,46,43,1,28,83,4,43,111,36,46
1f44ac21,Erling Haaland,23,Manchester City,Premier League,28.4,2000,FW,10,1,11,2,66.7,3,1,16,0,2,6,3,0,8,3,3
1f60244a,Benat Prados,22,Athletic Club,La Liga,16.1,2001,"MF,DF",27,5,32,23,54.8,42,19,27,0,23,45,11,11,68,23,28
1f875ef8,Jorge Moreno,22,Osasuna,La Liga,0.2,2001,DF,1,0,1,0,"",0,0,3,0,0,0,0,0,0,0,0
1fc08838,Frans Kratzig,20,Bayern Munich,Bundesliga,0.6,2003,DF,0,0,0,1,50.0,2,1,0,0,0,2,0,2,2,0,0
1fc474ae,Giovanni Gonzalez,28,Mallorca,La Liga,27.4,1994,DF,21,3,24,40,49.4,81,41,60,2,31,73,4,37,104,32,45
1fc4f3d1,Ilia Gruev,23,Werder Bremen,Bundesliga,0.0,2000,MF,0,0,0,0,"",0,0,0,0,0,0,0,0,0,0,0
1fca9171,Federico Di Francesco,29,Lecce,Serie A,0.2,1994,"FW,MF",0,0,0,0,"",0,0,0,0,0,1,0,0,1,1,0
1fda2b14,Marko Milovanovic,19,Almería,La Liga,3.4,2003,"FW,MF",2,0,2,2,50.0,4,2,5,0,0,4,0,1,4,3,4
1fe0492d,Ruben Duarte,27,Alavés,La Liga,20.9,1995,DF,15,6,21,21,67.7,31,10,69,0,23,39,2,21,62,16,20
1fffae99,Jens Stage,26,Werder Bremen,Bundesliga,25.9,1996,MF,19,23,42,18,36.0,50,32,55,0,23,52,8,21,75,23,22
20030c06,Willi Orban,30,RB Leipzig,Bundesliga,17.6,1992,DF,9,13,22,9,50.0,18,9,76,1,16,20,2,8,36,10,12
20094685,Maxime Lopez,25,Sassuolo,Serie A,1.6,1997,MF,0,1,1,1,50.0,2,1,0,0,2,2,0,1,4,1,1
200e89e1,Ander Barrenetxea,21,Real Sociedad,La Liga,15.9,2001,"FW,MF",17,1,18,10,38.5,26,16,5,0,6,32,9,7,38,16,21
202b3b68,Jakub Kaminski,21,Wolfsburg,Bundesliga,5.3,2002,"FW,MF",3,0,3,3,50.0,6,3,5,0,2,14,0,12,16,2,5
204ac005,Samuele Birindelli,24,Monza,Serie A,22.4,1999,DF,19,11,30,14,56.0,25,11,48,0,18,28,5,16,46,7,19
204dded0,Hiroki Ito,24,Stuttgart,Bundesliga,24.8,1999,DF,12,17,29,11,42.3,26,15,86,2,29,19,0,13,48,6,18
2054d037,"M'Baye Niang",28,Empoli,Serie A,7.9,1994,FW,6,1,7,0,0.0,6,6,10,0,3,3,2,0,6,1,1
20730eae,Rafael Leao,24,Milan,Serie A,27.9,1999,FW,14,1,15,8,61.5,13,5,19,0,9,16,5,3,25,8,10
2077ae86,Jonas Wind,24,Wolfsburg,Bundesliga,29.5,1999,FW,9,4,13,7,41.2,17,10,21,0,3,13,3,4,16,6,10
20a65cdf,Yarek Hernandis,18,Valencia,La Liga,8.2,2005,DF,7,8,15,13,68.4,19,6,50,1,15,22,3,14,37,5,12
20b104bc,Adam Smith,32,Bournemouth,Premier League,23.9,1991,DF,17,11,28,19,48.7,39,20,62,0,21,37,8,18,58,11,23
20b3a502,Nicolas Dominguez,25,Bologna,Serie A,1.1,1998,MF,3,0,3,0,0.0,2,2,2,0,0,1,0,1,1,0,0
20e73fac,Benjamin Bourigeaud,29,Rennes,Ligue 1,26.9,1994,"MF,FW",29,2,31,13,29.5,44,31,39,2,22,31,8,14,53,9,18
211589b8,Jon Karrikaburu,20,Alavés,La Liga,0.2,2002,"MF,FW",0,0,0,0,"",0,0,0,0,0,0,0,0,0,0,0
21166ff4,Caglar Soyuncu,27,Atlético Madrid,La Liga,1.3,1996,DF,1,0,1,0,"",0,0,7,0,1,1,0,1,2,0,1
213ab9bb,Oscar Estupinan,26,Metz,Ligue 1,2.9,1996,FW,2,0,2,1,50.0,2,1,0,0,0,5,2,0,5,3,4
2146785a,Davide Calabria,26,Milan,Serie A,24.3,1996,DF,19,7,26,44,61.1,72,28,49,1,24,70,7,38,94,25,38
21512407,Kieran Trippier,32,Newcastle Utd,Premier League,24.8,1990,DF,33,8,41,37,48.1,77,40,57,3,24,57,11,30,81,16,27
215f3907,Mikkel Damsgaard,23,Brentford,Premier League,9.4,2000,MF,22,1,23,14,35.0,40,26,10,1,11,29,7,13,40,9,17
217875a4,Sebastian Walukiewicz,23,Empoli,Serie A,22.8,2000,DF,19,31,50,28,68.3,41,13,121,0,15,39,0,33,54,6,28
217c93a1,Lazar Samardzic,21,Udinese,Serie A,26.4,2002,MF,20,6,26,16,41.0,39,23,25,0,10,40,4,18,50,18,19
2180c761,El Chadaille Bitshiabu,18,RB Leipzig,Bundesliga,0.4,2005,"DF,MF",0,0,0,0,"",0,0,4,0,1,1,0,1,2,0,0
21945a9e,Dane Scarlett,19,Tottenham,Premier League,0.2,2004,FW,0,0,0,0,0.0,1,1,0,0,0,1,1,0,1,0,1
21a66f6a,Harry Kane,30,Bayern Munich,Bundesliga,31.5,1993,FW,8,4,12,6,33.3,18,12,14,0,6,13,5,4,19,4,9
22051fbe,Giulio Donati,33,Monza,Serie A,0.4,1990,DF,0,0,0,0,"",0,0,1,1,0,0,0,0,0,0,0
220ace7e,Romano Schmid,23,Werder Bremen,Bundesliga,28.9,2000,"MF,FW",29,7,36,14,30.4,46,32,17,2,11,35,6,7,46,22,20
220c11f1,Cristhian Stuani,36,Girona,La Liga,8.9,1986,FW,7,2,9,4,57.1,7,3,13,0,5,14,4,4,19,6,11
22371dee,Damian Rodriguez,20,Celta Vigo,La Liga,2.9,2003,MF,2,2,4,1,33.3,3,2,2,0,1,6,2,1,7,3,3
2244908c,Andreas Muller,23,Darmstadt 98,Bundesliga,3.9,2000,MF,3,2,5,4,44.4,9,5,5,0,4,14,1,8,18,5,9
226008f1,Luca Caldirola,32,Monza,Serie A,23.8,1991,DF,9,17,26,13,59.1,22,9,53,0,29,25,2,19,54,4,14
226673c2,Bilal Nadir,19,Marseille,Ligue 1,1.3,2003,"MF,FW",0,0,0,1,50.0,2,1,2,0,2,4,0,2,6,2,3
22721b88,Jordan Amavi,29,Brest,Ligue 1,1.0,1994,DF,1,1,2,1,33.3,3,2,2,0,3,1,0,0,4,1,1
22798128,Aissa Laidouni,26,Union Berlin,Bundesliga,11.9,1996,MF,24,2,26,4,33.3,12,8,14,2,12,21,5,4,33,12,12
227f25be,Alessandro Dellavalle,19,Torino,Serie A,0.2,2004,DF,0,1,1,0,"",0,0,0,0,1,0,0,0,1,0,0
228b0d9d,Aihen Munoz,25,Real Sociedad,La Liga,12.5,1997,DF,8,8,16,24,68.6,35,11,33,0,9,36,6,20,45,10,21
22919e97,Sargis Adamyan,30,Köln,Bundesliga,8.9,1993,"FW,MF",15,1,16,6,54.5,11,5,7,0,5,14,3,2,19,9,9
22ae86f9,Diego Coppola,19,Hellas Verona,Serie A,18.2,2003,DF,17,9,26,20,60.6,33,13,89,1,27,36,2,25,63,9,22
22bfb57e,Jean-Victor Makengo,25,Lorient,Ligue 1,5.3,1998,"MF,FW",11,1,12,2,33.3,6,4,5,0,8,5,0,3,13,2,4
22d90df9,Ibou Sane,18,Metz,Ligue 1,1.4,2005,"MF,FW",3,0,3,2,100.0,2,0,2,0,1,6,3,2,7,1,4
230a2fac,Giovanni Di Lorenzo,29,Napoli,Serie A,35.9,1993,DF,27,16,43,32,47.1,68,36,45,0,24,58,6,26,82,26,36
230c3f3a,Ibrahim Sulemana,20,Cagliari,Serie A,14.9,2003,MF,19,5,24,17,63.0,27,10,23,0,7,36,6,15,43,15,14
230f0471,Nathan Patterson,21,Everton,Premier League,11.2,2001,DF,11,3,14,14,37.8,37,23,33,0,9,34,2,21,43,11,24
231c67ff,Nelson Weiper,18,Mainz 05,Bundesliga,1.4,2005,"FW,MF",1,0,1,2,66.7,3,1,0,0,1,2,0,2,3,0,1
2321ea6e,Vincent Le Goff,33,Lorient,Ligue 1,6.0,1989,"DF,MF",8,3,11,4,50.0,8,4,10,0,3,5,1,4,8,0,0
232b3da4,Stefan Mitrovic,20,Hellas Verona,Serie A,4.3,2002,"FW,MF",5,1,6,2,40.0,5,3,4,0,0,6,1,0,6,5,3
234a703c,Ernest Nuamah,19,Lyon,Ligue 1,20.4,2003,"FW,MF",14,1,15,12,31.6,38,26,9,0,8,28,4,18,36,6,14
23610943,Nahuel Molina,25,Atlético Madrid,La Liga,20.6,1998,DF,16,3,19,26,48.1,54,28,36,1,9,38,4,16,47,18,22
236f02cd,Joe Scally,20,Gladbach,Bundesliga,24.8,2002,DF,20,11,31,23,57.5,40,17,78,2,18,41,3,21,59,17,28
2374aaca,Nicolas Gonzalez,25,Fiorentina,Serie A,21.3,1998,FW,25,1,26,8,28.6,28,20,9,0,12,28,5,15,40,8,18
237a3851,Kike Perez,26,Rayo Vallecano,La Liga,9.3,1997,"MF,FW",11,0,11,11,47.8,23,12,6,0,8,27,1,11,35,15,11
2389cdc2,Matty Cash,25,Aston Villa,Premier League,23.8,1997,DF,21,14,35,29,49.2,59,30,59,0,18,54,6,24,72,24,31
23c63b7f,Ignatius Ganago,24,Nantes,Ligue 1,2.0,1999,"FW,MF",1,0,1,0,0.0,1,1,1,0,1,0,0,0,1,0,0
23cbf863,Carlos Romero,21,Villarreal,La Liga,2.9,2001,DF,3,0,3,7,58.3,12,5,11,0,1,11,2,8,12,1,5
23d73767,Joseph Nonge,18,Juventus,Serie A,0.3,2005,MF,0,0,0,0,"",0,0,1,0,0,0,0,0,0,0,0
240d3a0b,Dani Garcia,33,Athletic Club,La Liga,8.3,1990,MF,6,3,9,12,50.0,24,12,11,0,8,17,6,4,25,7,11
244bc2c8,Boulaye Dia,26,Salernitana,Serie A,12.7,1996,"FW,MF",5,0,5,1,33.3,3,2,7,0,3,4,0,2,7,2,2
246d153b,Ola Aina,26,"Nott'ham Forest",Premier League,18.8,1996,DF,16,3,19,29,70.7,41,12,51,1,18,47,4,31,65,12,31
2475cf9b,Juan Brandariz,24,Almería,La Liga,27.0,1999,DF,15,23,38,16,61.5,26,10,107,3,14,34,0,22,48,12,22
247ed022,Andrea Cambiaso,23,Juventus,Serie A,26.4,2000,"DF,FW",25,3,28,25,58.1,43,18,26,1,11,47,9,23,58,15,30
24eb7ed6,Junior Sambia,26,Salernitana,Serie A,11.5,1996,"DF,MF",8,7,15,6,54.5,11,5,28,0,11,12,3,8,23,1,5
24fae784,Connor Roberts,27,Burnley,Premier League,9.1,1995,DF,2,6,8,8,47.1,17,9,25,2,4,12,2,6,16,4,5
2500cef9,Yoane Wissa,26,Brentford,Premier League,27.7,1996,FW,21,3,24,5,25.0,20,15,15,0,9,28,5,13,37,10,16
25355bd8,Jonathan Asp Jensen,17,Bayern Munich,Bundesliga,0.0,2006,FW,0,0,0,0,"",0,0,1,0,0,0,0,0,0,0,0
253a06b9,Ezequiel Avila,29,Betis,La Liga,3.3,1994,FW,2,0,2,1,33.3,3,2,4,0,1,2,0,0,3,2,1
253bd2b3,Lovro Zvonarek,18,Bayern Munich,Bundesliga,1.8,2005,"FW,MF",3,0,3,0,0.0,5,5,2,0,0,0,0,0,0,0,0
25749008,Elba Rashani,30,Clermont Foot,Ligue 1,13.1,1993,"MF,FW",14,3,17,11,45.8,24,13,15,0,12,30,9,4,42,17,18
258a6f4d,Tim Kleindienst,27,Heidenheim,Bundesliga,31.9,1995,FW,24,8,32,7,28.0,25,18,58,0,12,21,4,6,33,11,12
25ab9c9c,Manuel Gulde,32,Freiburg,Bundesliga,22.7,1991,DF,10,14,24,17,73.9,23,6,82,0,25,37,1,23,62,13,23
25b82f9a,Theo Corbeanu,21,Granada,La Liga,2.0,2002,"MF,FW",3,0,3,1,33.3,3,2,2,0,3,5,0,2,8,3,2
25f2ef01,"Jake O'Brien",22,Lyon,Ligue 1,26.3,2001,DF,5,18,23,14,70.0,20,6,98,1,12,22,1,16,34,5,16
2658c82f,Aleksandar Pavlovic,19,Bayern Munich,Bundesliga,13.6,2004,MF,10,3,13,17,51.5,33,16,12,0,17,28,4,10,45,14,16
26777636,Yacine Adli,23,Milan,Serie A,15.6,2000,MF,14,8,22,13,37.1,35,22,15,1,20,34,4,17,54,13,17
2677a1de,Wahbi Khazri,32,Montpellier,Ligue 1,12.6,1991,FW,10,0,10,14,40.0,35,21,7,0,3,24,4,8,27,12,17
26952edc,Joao Costa,18,Roma,Serie A,0.2,2005,"MF,FW",0,0,0,0,"",0,0,0,0,0,0,0,0,0,0,0
2696b6a9,Tahith Chong,23,Luton Town,Premier League,22.0,1999,"MF,FW",24,6,30,15,45.5,33,18,11,1,8,36,4,19,44,13,22
26ce2263,Ryan Christie,28,Bournemouth,Premier League,32.3,1995,MF,41,11,52,39,42.4,92,53,53,1,52,86,17,34,138,35,44
26db8853,Walace,28,Udinese,Serie A,36.0,1995,MF,37,6,43,36,46.8,77,41,66,1,43,66,0,40,109,26,43
274ab13c,Catena,28,Osasuna,La Liga,28.2,1994,DF,9,15,24,19,54.3,35,16,119,3,15,33,1,26,48,6,18
277c49ed,Maxence Lacroix,23,Wolfsburg,Bundesliga,26.2,2000,DF,23,12,35,29,70.7,41,12,121,0,24,48,2,28,72,18,29
2784f898,Eder Militao,25,Real Madrid,La Liga,5.5,1998,DF,1,3,4,6,66.7,9,3,19,1,4,7,0,4,11,3,3
279508bf,Brenner,23,Udinese,Serie A,2.1,2000,"MF,FW",2,0,2,4,57.1,7,3,2,0,0,8,2,1,8,5,7
27d0a506,Pedro Porro,23,Tottenham,Premier League,34.3,1999,DF,45,18,63,62,51.7,120,58,102,3,34,91,14,43,125,34,63
27dc1378,Jose Luis Garcia Vaya,24,Valencia,La Liga,36.7,1998,MF,31,10,41,37,52.1,71,34,71,0,49,78,6,36,127,36,53
282f75f3,Lewis Dunk,31,Brighton,Premier League,31.9,1991,DF,12,37,49,13,36.1,36,23,90,1,31,27,1,17,58,9,14
285c7011,Thomas Keller,23,Heidenheim,Bundesliga,0.0,1999,"MF,FW",0,0,0,0,"",0,0,0,0,0,0,0,0,0,0,0
2886c9b5,Shandon Baptiste,25,Brentford,Premier League,2.5,1998,MF,4,1,5,1,20.0,5,4,6,0,3,4,0,2,7,2,4
288e1e13,Nayef Aguerd,27,West Ham,Premier League,20.6,1996,DF,9,24,33,16,72.7,22,6,85,2,17,26,0,19,43,7,14
289601e6,Antonee Robinson,25,Fulham,Premier League,36.3,1997,DF,48,8,56,52,47.3,110,58,117,3,80,93,7,60,173,26,58
28b40c9c,Tim Ream,35,Fulham,Premier League,16.7,1987,DF,8,15,23,9,50.0,18,9,61,2,25,20,2,13,45,5,9
28c6e925,Nicolas Seiwald,22,RB Leipzig,Bundesliga,8.0,2001,MF,10,2,12,16,64.0,25,9,15,0,8,33,2,16,41,15,18
28e1d1ea,Mohamed Bouchenna,17,Clermont Foot,Ligue 1,0.3,2006,"MF,FW",0,0,0,0,"",0,0,0,0,0,1,0,1,1,0,0
28e85bea,Patrick Ouotro,17,Strasbourg,Ligue 1,0.1,2005,FW,0,0,0,0,"",0,0,0,0,0,0,0,0,0,0,0
28e957d7,Cesar Montes,26,Almería,La Liga,19.9,1997,DF,12,9,21,9,50.0,18,9,94,0,11,22,0,13,33,9,13
28f66c2e,Brandon Soppy,21,Torino,Serie A,2.0,2002,DF,2,0,2,2,33.3,6,4,3,1,0,2,0,1,2,1,2
2903a856,Jonas Hofmann,31,Leverkusen,Bundesliga,24.5,1992,MF,18,0,18,10,41.7,24,14,6,0,8,20,5,6,28,9,14
2944f86f,Frank Onyeka,25,Brentford,Premier League,12.9,1998,MF,8,7,15,16,55.2,29,13,17,0,23,37,5,9,60,23,24
2946f9a1,Nacho,33,Real Madrid,La Liga,19.4,1990,DF,10,13,23,6,46.2,13,7,56,0,18,18,2,9,36,7,10
2973a975,Aiham Ousou,23,Cádiz,La Liga,4.8,2000,DF,1,0,1,5,100.0,5,0,15,0,7,8,0,6,15,2,5
2979c05a,Gerrit Holtmann,28,Darmstadt 98,Bundesliga,4.4,1995,"MF,FW",7,0,7,7,70.0,10,3,4,1,2,8,1,3,10,4,5
298c8aa1,Tomas Cvancara,22,Gladbach,Bundesliga,10.0,2000,FW,4,1,5,1,33.3,3,2,8,0,2,4,2,0,6,2,3
29aee77c,Fraser Hornby,23,Darmstadt 98,Bundesliga,2.4,1999,"FW,MF",1,1,2,0,0.0,1,1,4,0,0,0,0,0,0,0,0
29c91632,Abakar Sylla,20,Strasbourg,Ligue 1,19.9,2002,DF,29,11,40,29,72.5,40,11,70,2,26,54,5,30,80,19,23
29f7cfd9,Simon Zoller,32,Bochum,Bundesliga,0.5,1991,"FW,MF",1,0,1,0,"",0,0,0,0,0,0,0,0,0,0,0
2a0c8ba4,Joan Jordan,29,Sevilla,La Liga,4.2,1994,MF,2,2,4,7,46.7,15,8,2,0,4,8,2,3,12,3,7
2a158218,Benedict Hollerbach,22,Union Berlin,Bundesliga,14.2,2001,"FW,MF",28,0,28,7,31.8,22,15,3,0,4,17,5,5,21,7,11
2a1beb34,Marten de Roon,32,Atalanta,Serie A,28.9,1991,"MF,DF",26,10,36,35,42.7,82,47,54,0,40,80,12,36,120,32,43
2a295d33,Samuel Lino,23,Atlético Madrid,La Liga,23.1,1999,"DF,MF",36,1,37,35,50.0,70,35,27,0,14,61,12,32,75,17,34
2a29eb9b,Lukas Kubler,30,Freiburg,Bundesliga,20.5,1992,DF,22,14,36,26,61.9,42,16,57,1,37,50,2,35,87,13,24
2a6cd437,Marin Pongracic,25,Lecce,Serie A,35.8,1997,DF,11,26,37,19,76.0,25,6,130,1,51,43,1,22,94,20,30
2a73f18d,Christian Kuhlwetter,27,Heidenheim,Bundesliga,0.1,1996,MF,0,0,0,0,"",0,0,0,0,0,0,0,0,0,0,0
2a7d27c1,Davide Frattesi,23,Inter,Serie A,10.6,1999,MF,6,3,9,4,50.0,8,4,19,0,5,10,0,3,15,7,6
2a82aa85,Grigoris Kastanos,25,Salernitana,Serie A,16.4,1998,"MF,DF",9,4,13,9,45.0,20,11,9,0,8,23,6,8,31,9,14
2aaadf33,Luke Berry,31,Luton Town,Premier League,3.6,1992,"MF,DF",5,1,6,2,66.7,3,1,3,0,0,7,1,2,7,4,2
2acd49b9,Moussa Sissoko,33,Nantes,Ligue 1,20.2,1989,MF,6,2,8,12,48.0,25,13,31,0,12,27,6,13,39,8,16
2acf0cd7,Marshall Munetsi,27,Reims,Ligue 1,24.1,1996,MF,14,7,21,33,54.1,61,28,33,0,14,61,9,18,75,34,39
2afc7272,Lewis Cook,26,Bournemouth,Premier League,31.0,1997,MF,21,11,32,34,54.0,63,29,46,1,65,61,7,24,126,30,41
2b09d998,Tyler Adams,24,Bournemouth,Premier League,1.3,1999,MF,2,0,2,2,66.7,3,1,2,0,4,4,0,1,8,3,3
2b114be3,Leroy Sane,27,Bayern Munich,Bundesliga,23.7,1996,FW,12,0,12,4,21.1,19,15,3,0,7,15,3,6,22,6,8
2b471f99,Mario Lemina,29,Wolves,Premier League,33.0,1993,MF,27,9,36,25,53.2,47,22,64,0,41,90,11,46,131,33,58
2b5a35e5,Dilane Bakwa,20,Strasbourg,Ligue 1,24.2,2002,"FW,MF",25,1,26,11,27.5,40,29,11,0,20,30,5,12,50,13,22
2b7cdb79,Amir Richardson,21,Reims,Ligue 1,15.0,2002,MF,21,5,26,10,45.5,22,12,30,0,15,33,3,12,48,18,23
2b8360f1,Cyril Ngonge,23,Napoli,Serie A,3.5,2000,FW,2,0,2,2,100.0,2,0,2,0,0,5,0,1,5,4,3
2b9fdeea,Florian Thauvin,30,Udinese,Serie A,19.0,1993,FW,8,1,9,4,30.8,13,9,2,0,3,7,1,2,10,4,4
2bab583c,Cedric Zesiger,25,Wolfsburg,Bundesliga,18.2,1998,DF,11,21,32,10,45.5,22,12,88,1,15,19,2,13,34,4,9
2bc7f211,Abdel Abqar,24,Alavés,La Liga,25.7,1999,DF,5,26,31,21,60.0,35,14,115,0,23,35,2,28,58,5,19
2bd83368,Anthony Gordon,22,Newcastle Utd,Premier League,32.1,2001,FW,27,0,27,22,34.4,64,42,7,0,7,55,11,16,62,28,34
2be28a0c,Thomas Isherwood,25,Darmstadt 98,Bundesliga,7.1,1998,DF,3,7,10,5,55.6,9,4,34,0,10,11,1,7,21,3,5
2bea832e,Juanmi Latasa,22,Getafe,La Liga,17.3,2001,FW,9,0,9,1,9.1,11,10,21,0,4,9,3,0,13,6,7
2bed3eab,Eric Garcia,22,Girona,La Liga,29.3,2001,DF,18,18,36,34,69.4,49,15,79,2,30,55,3,34,85,18,37
2bef2bca,Ronald Araujo,24,Barcelona,La Liga,22.2,1999,DF,9,11,20,12,70.6,17,5,66,2,12,27,1,11,39,15,22
2c0558b8,Jamal Musiala,20,Bayern Munich,Bundesliga,19.5,2003,"MF,FW",24,1,25,14,38.9,36,22,5,0,16,40,10,9,56,21,25
2c08cab0,Gustavo Puerta,20,Leverkusen,Bundesliga,0.5,2003,"DF,MF",2,0,2,1,50.0,2,1,0,0,0,5,1,2,5,2,3
2c0f8e9e,Alexis Sanchez,34,Inter,Serie A,8.5,1988,"FW,MF",3,1,4,1,25.0,4,3,3,0,1,7,2,0,8,5,6
2c3a6c21,Marco Mancosu,34,Cagliari,Serie A,1.7,1988,"MF,FW",0,0,0,1,50.0,2,1,0,0,0,3,1,0,3,2,0
2c6835e5,Lewis Miley,17,Newcastle Utd,Premier League,13.4,2006,MF,17,3,20,15,46.9,32,17,18,2,8,33,7,6,41,20,21
2c70d915,Christian Mawissa,18,Toulouse,Ligue 1,12.4,2005,DF,11,11,22,9,39.1,23,14,41,1,22,22,4,14,44,4,15
2c9e6bc3,Sergio Rodelas,18,Granada,La Liga,1.4,2004,"FW,DF",0,0,0,0,0.0,3,3,0,0,0,3,2,1,3,0,2
2ccd39ed,Akor Adams,23,Montpellier,Ligue 1,25.0,2000,FW,7,2,9,3,42.9,7,4,11,0,5,12,5,3,17,4,4
2ccd89a3,Eduard Sobol,28,Strasbourg,Ligue 1,0.3,1995,DF,0,0,0,0,"",0,0,1,0,0,0,0,0,0,0,0
2cf496fb,Kamil Piatkowski,23,Granada,La Liga,5.6,2000,DF,1,5,6,10,71.4,14,4,28,1,8,18,1,16,26,1,10
2cfb6e88,Hugo Gonzalez,20,Valencia,La Liga,1.0,2003,"MF,FW",0,0,0,0,"",0,0,0,0,0,2,0,0,2,2,1
2d22cea7,Armand Lauriente,24,Sassuolo,Serie A,32.3,1998,FW,25,4,29,13,29.5,44,31,11,0,15,31,9,8,46,14,20
2d3d7c0d,Filippo Missori,19,Sassuolo,Serie A,3.0,2004,DF,1,2,3,4,36.4,11,7,8,0,4,6,0,2,10,4,3
2d5f03bf,Christoph Zimmermann,30,Darmstadt 98,Bundesliga,13.6,1993,DF,7,14,21,19,48.7,39,20,66,1,21,33,0,26,54,7,21
2d5f2ff0,Justin Kumi,19,Sassuolo,Serie A,0.0,2004,FW,0,0,0,0,"",0,0,0,0,0,0,0,0,0,0,0
2d61d13a,Ozan Kabak,23,Hoffenheim,Bundesliga,25.4,2000,DF,22,21,43,19,57.6,33,14,106,2,46,48,2,32,94,14,35
2d6b4904,Bennit Broger,17,Wolfsburg,Bundesliga,0.1,2006,FW,0,0,0,0,"",0,0,0,0,0,0,0,0,0,0,0
2d970560,Robin Gosens,29,Union Berlin,Bundesliga,25.4,1994,"DF,MF",43,9,52,30,68.2,44,14,75,0,36,63,7,25,99,31,44
2d9d9e42,Kacper Urbanski,18,Bologna,Serie A,10.3,2004,"MF,FW",14,1,15,6,46.2,13,7,14,0,4,16,1,5,20,10,10
2da834f1,Carlton Morris,27,Luton Town,Premier League,31.8,1995,"FW,MF",19,5,24,9,60.0,15,6,53,0,1,15,5,4,16,6,8
2db2fd7b,Jerome Boateng,34,Salernitana,Serie A,2.6,1988,DF,1,5,6,0,"",0,0,21,0,4,0,0,0,4,0,0
2dce876a,Carmona,21,Getafe,La Liga,14.6,2002,"DF,MF",13,2,15,9,32.1,28,19,25,0,21,30,3,13,51,14,21
2df7cc43,Bruno Amione,21,Hellas Verona,Serie A,6.4,2002,DF,2,2,4,4,80.0,5,1,19,2,9,11,0,9,20,2,3
2e1b7c83,Emmanuel Sabbi,25,Le Havre,Ligue 1,17.6,1997,"FW,MF",24,2,26,16,41.0,39,23,7,0,19,38,8,15,57,15,19
2e31f3a6,Hector Fort,16,Barcelona,La Liga,3.5,2006,DF,0,0,0,4,40.0,10,6,4,0,2,6,0,5,8,1,5
2e3995cd,Brian Ocampo,24,Cádiz,La Liga,2.8,1999,"MF,FW",4,0,4,2,40.0,5,3,0,0,3,4,0,1,7,3,3
2e4f5f03,Andrew Robertson,29,Liverpool,Premier League,18.8,1994,DF,14,6,20,26,60.5,43,17,40,0,13,35,3,21,48,11,24
2e5915f1,Morgan Rogers,21,Aston Villa,Premier League,7.1,2002,"MF,FW",11,0,11,2,18.2,11,9,11,0,3,8,3,3,11,2,1
2e77d607,Andreas Hanche-Olsen,26,Mainz 05,Bundesliga,11.0,1997,DF,6,4,10,10,62.5,16,6,41,0,11,20,2,10,31,8,12
2ead2809,Gianluca Lapadula,33,Cagliari,Serie A,13.4,1990,FW,1,1,2,1,10.0,10,9,5,0,2,1,1,0,3,0,1
2eb1ec07,Amadou Kone,18,Reims,Ligue 1,5.3,2005,MF,5,3,8,6,60.0,10,4,10,0,10,13,0,11,23,2,8
2edcd048,Davide Bettella,23,Monza,Serie A,0.0,2000,MF,0,0,0,0,"",0,0,0,0,0,0,0,0,0,0,0
2ee5b0c9,Zeki Amdouni,22,Burnley,Premier League,21.7,2000,FW,13,10,23,7,28.0,25,18,10,0,9,27,11,1,36,15,18
2ef08833,Marc Casado,19,Barcelona,La Liga,0.2,2003,MF,0,0,0,1,100.0,1,0,2,0,1,1,0,1,2,0,1
2ef7c612,Charles De Ketelaere,22,Atalanta,Serie A,22.5,2001,"FW,MF",28,2,30,10,50.0,20,10,6,0,7,33,18,3,40,12,21
2f067cf2,Tijjani Noslin,24,Hellas Verona,Serie A,14.9,1999,"FW,MF",15,2,17,6,37.5,16,10,14,0,2,18,6,5,20,7,8
2f3452eb,Elseid Hysaj,29,Lazio,Serie A,13.3,1994,DF,10,6,16,15,62.5,24,9,31,0,17,24,3,8,41,13,14
2f3e911a,Aaron Martin,26,Genoa,Serie A,15.3,1997,DF,8,4,12,9,40.9,22,13,15,0,9,21,4,7,30,10,10
2f5c78ca,Mikel Jauregizar,19,Athletic Club,La Liga,1.7,2003,MF,5,0,5,0,0.0,6,6,2,0,0,0,0,0,0,0,0
2f69d881,Josh Doig,21,Sassuolo,Serie A,14.9,2002,DF,21,10,31,15,55.6,27,12,38,0,16,25,0,16,41,9,17
2f71c116,Maxime Colin,31,Metz,Ligue 1,20.4,1991,DF,15,7,22,16,55.2,29,13,71,0,20,39,7,25,59,7,23
2f7fec15,Lilian Egloff,20,Stuttgart,Bundesliga,1.2,2002,"MF,DF",2,1,3,2,50.0,4,2,0,0,1,4,0,3,5,1,1
2f90f6b8,James Milner,37,Brighton,Premier League,8.6,1986,"DF,MF",9,0,9,9,64.3,14,5,16,0,8,20,1,9,28,10,14
2f9e4435,Dango Ouattara,21,Bournemouth,Premier League,13.7,2002,"FW,DF",15,3,18,19,55.9,34,15,35,0,22,45,12,22,67,11,27
2f9ef1a8,Pablo Saenz,"",Granada,La Liga,0.2,,MF,0,0,0,1,33.3,3,2,0,0,0,3,1,2,3,0,3
2fba6108,Anthony Elanga,21,"Nott'ham Forest",Premier League,27.0,2002,"FW,MF",20,2,22,17,47.2,36,19,20,1,8,33,7,20,41,6,19
2ff76adc,Phillipp Mwene,29,Mainz 05,Bundesliga,22.2,1994,DF,24,3,27,16,48.5,33,17,47,0,17,34,3,15,51,16,15
3010aefb,Marcus Coco,27,Nantes,Ligue 1,16.5,1996,"DF,FW",18,1,19,28,46.7,60,32,38,0,21,43,4,29,64,10,26
301c287b,Douglas,26,Nantes,Ligue 1,19.7,1997,MF,14,8,22,30,50.8,59,29,30,0,26,70,6,34,96,30,42
302527b2,Philipp Lienhart,27,Freiburg,Bundesliga,14.1,1996,DF,7,11,18,13,56.5,23,10,51,0,14,20,1,14,34,5,13
30297946,Samuele Mulattieri,22,Sassuolo,Serie A,5.1,2000,"FW,MF",5,2,7,1,50.0,2,1,2,0,1,1,1,0,2,0,1
307581ff,Ichem Ferrah,17,Lille,Ligue 1,0.0,2005,FW,0,0,0,0,"",0,0,0,0,0,0,0,0,0,0,0
30941e96,Angelino,26,Roma,Serie A,12.7,1997,DF,6,5,11,11,57.9,19,8,37,1,12,21,3,12,33,6,11
30ae134d,Kevin Behrens,32,Union Berlin,Bundesliga,14.0,1991,FW,5,2,7,1,25.0,4,3,19,0,6,13,3,3,19,7,10
30af8b93,Caio Henrique Oliveira Silva,26,Monaco,Ligue 1,6.9,1997,DF,6,2,8,6,66.7,9,3,9,0,6,13,3,3,19,7,7
30c220c3,Mitchell Weiser,29,Werder Bremen,Bundesliga,29.3,1994,"DF,MF",30,6,36,31,58.5,53,22,43,0,20,64,10,29,84,25,38
30d4a2e5,Vitaliy Mykolenko,24,Everton,Premier League,27.4,1999,DF,25,11,36,41,62.1,66,25,92,0,36,69,2,46,105,21,38
30e81a88,Rhian Brewster,23,Sheffield Utd,Premier League,3.8,2000,"FW,MF",2,0,2,0,0.0,2,2,2,0,1,5,2,1,6,2,1
30f5ffa9,Milan Skriniar,28,Paris S-G,Ligue 1,18.1,1995,DF,9,10,19,14,63.6,22,8,51,2,12,24,0,17,36,7,18
313254a3,Kiliann Sildillia,21,Freiburg,Bundesliga,20.1,2002,DF,18,15,33,26,61.9,42,16,64,0,22,43,7,28,65,8,19
31626657,Laurent Abergel,30,Lorient,Ligue 1,31.8,1993,MF,23,6,29,38,39.6,96,58,61,3,61,85,8,43,146,34,52
31822f8c,Folarin Balogun,22,Monaco,Ligue 1,18.8,2001,FW,10,0,10,5,38.5,13,8,4,0,3,12,1,3,15,8,4
3189f61a,Nabil Bentaleb,28,Lille,Ligue 1,21.9,1994,MF,21,12,33,22,51.2,43,21,33,0,37,49,2,29,86,18,32
319fa018,Leon Opitz,18,Werder Bremen,Bundesliga,0.2,2005,"FW,DF",0,0,0,2,66.7,3,1,0,0,0,2,0,1,2,1,2
31a62dc7,Zeki Celik,26,Roma,Serie A,7.5,1997,DF,7,5,12,14,56.0,25,11,25,0,8,23,3,10,31,10,16
31b252fc,Ilario Monterisi,21,Frosinone,Serie A,16.3,2001,DF,4,18,22,12,46.2,26,14,63,0,8,23,2,14,31,7,13
31c69ef1,Ruben Dias,26,Manchester City,Premier League,28.4,1997,DF,15,17,32,19,73.1,26,7,77,0,30,39,4,14,69,21,20
31d45cc8,Alvaro Lemos,30,Las Palmas,La Liga,2.8,1993,DF,2,1,3,0,0.0,2,2,4,0,2,4,0,1,6,3,1
31f5b89b,Paul Akouokou,25,Lyon,Ligue 1,3.4,1997,MF,4,1,5,6,85.7,7,1,11,0,6,14,2,2,20,10,9
32100829,Koffi Kouao,25,Metz,Ligue 1,9.6,1998,DF,3,6,9,11,64.7,17,6,38,1,13,20,1,12,33,7,13
32163807,Ben Parkinson,18,Newcastle Utd,Premier League,0.3,2005,FW,1,0,1,0,"",0,0,1,0,0,0,0,0,0,0,0
3239a8ed,"Rafa Marin ",21,Alavés,La Liga,27.1,2002,DF,13,21,34,14,51.9,27,13,129,2,33,32,0,23,65,9,20
324ff0da,Jacob Christensen,22,Köln,Bundesliga,2.4,2001,MF,6,2,8,4,57.1,7,3,4,0,4,10,0,7,14,3,6
3260690c,Benjamin Sesko,20,RB Leipzig,Bundesliga,17.0,2003,FW,21,2,23,2,22.2,9,7,27,0,3,13,4,2,16,7,5
32974271,Sergi Guardiola,32,Cádiz,La Liga,5.5,1991,"FW,MF",10,0,10,4,44.4,9,5,4,0,0,10,2,2,10,6,7
32c2d95f,Yunis Abdelhamid,35,Reims,Ligue 1,30.9,1987,DF,19,32,51,26,57.8,45,19,109,2,39,64,5,36,103,23,35
32e8417f,Stefan Bajcetic,18,Liverpool,Premier League,0.3,2004,MF,0,0,0,3,60.0,5,2,0,0,0,4,0,3,4,1,1
32f3d97e,Abdoul Kader Bamba,29,Nantes,Ligue 1,6.8,1994,"FW,MF",4,0,4,5,33.3,15,10,4,1,4,10,3,2,14,5,7
32f60ed8,Morgan Gibbs-White,23,"Nott'ham Forest",Premier League,35.1,2000,"MF,FW",23,8,31,14,42.4,33,19,21,0,17,36,10,6,53,20,24
3312f911,Jeffrey Schlupp,30,Crystal Palace,Premier League,15.0,1992,"FW,MF",11,2,13,9,50.0,18,9,24,0,8,38,8,14,46,16,24
331c5a98,Mamadou Diakhon,17,Reims,Ligue 1,2.3,2005,"FW,MF",1,0,1,3,33.3,9,6,1,0,1,5,2,2,6,1,3
3322e296,Antoine Mendy,19,Nice,Ligue 1,4.6,2004,DF,3,1,4,3,42.9,7,4,16,0,8,7,0,4,15,3,5
3353737a,Sergio Reguilon,26,Brentford,Premier League,12.4,1996,DF,17,6,23,24,60.0,40,16,41,1,16,45,1,26,61,18,20
335fa267,Sergi Roberto,31,Barcelona,La Liga,9.6,1992,"MF,DF",5,2,7,3,27.3,11,8,7,1,8,15,1,4,23,10,10
3397e7b5,Phillip Tietz,26,Augsburg,Bundesliga,26.5,1997,FW,14,3,17,6,40.0,15,9,35,0,6,23,3,7,29,13,14
33a68b9b,Alvaro Carreras,20,Granada,La Liga,5.3,2003,"MF,FW",4,1,5,5,45.5,11,6,9,1,7,13,1,8,20,4,8
33b38f49,Bambase Conte,20,Hoffenheim,Bundesliga,0.5,2003,"MF,FW",0,0,0,1,100.0,1,0,0,0,0,3,1,2,3,0,3
3423f250,Raphinha,26,Barcelona,La Liga,15.2,1996,"FW,MF",16,1,17,4,22.2,18,14,11,0,13,14,2,6,27,6,8
34269bdf,Renato Tapia,28,Celta Vigo,La Liga,14.9,1995,"MF,DF",24,7,31,14,56.0,25,11,50,1,21,41,3,19,62,19,29
343c0d52,Giovanni Simeone,28,Napoli,Serie A,8.9,1995,FW,11,0,11,3,25.0,12,9,7,0,1,12,8,1,13,3,4
34693494,Fabio Miretti,19,Juventus,Serie A,12.3,2003,MF,9,1,10,10,38.5,26,16,6,0,7,18,4,6,25,8,14
346d51d9,Julian Weigl,27,Gladbach,Bundesliga,30.7,1995,MF,33,14,47,41,61.2,67,26,61,1,48,66,6,28,114,32,40
34721c11,Tawanda Chirewa,19,Wolves,Premier League,1.6,2003,"MF,FW",0,0,0,2,66.7,3,1,0,0,1,7,1,3,8,3,3
3489184e,Matthias Bader,26,Darmstadt 98,Bundesliga,20.0,1997,"DF,MF",18,4,22,33,50.8,65,32,20,0,25,51,8,32,76,11,25
349cae8f,Michael Amir Murillo,27,Marseille,Ligue 1,11.1,1996,DF,7,2,9,15,65.2,23,8,34,2,11,23,4,13,34,6,11
34a88e3e,Edon Zhegrova,24,Lille,Ligue 1,25.4,1999,FW,16,1,17,14,38.9,36,22,8,0,8,32,8,9,40,15,18
34b0387f,Lee Jae-sung,30,Mainz 05,Bundesliga,23.5,1992,"MF,FW",20,2,22,13,33.3,39,26,23,0,27,33,6,11,60,16,20
34b54da7,Tony Jantschke,33,Gladbach,Bundesliga,0.3,1990,"DF,MF",0,2,2,1,100.0,1,0,4,0,1,1,0,1,2,0,1
34e12499,Nico Schlotterbeck,23,Dortmund,Bundesliga,31.8,1999,DF,27,25,52,41,63.1,65,24,101,3,45,70,7,36,115,27,50
34e393f2,Guido Rodriguez,29,Betis,La Liga,20.5,1994,MF,21,6,27,34,61.8,55,21,44,0,29,53,8,21,82,24,30
34e39a18,Eric Curbelo,29,Las Palmas,La Liga,1.1,1994,"DF,MF",2,1,3,3,75.0,4,1,5,1,2,4,0,2,6,2,3
35141f4c,Marcos Senesi,26,Bournemouth,Premier League,24.9,1997,DF,27,23,50,24,42.9,56,32,109,1,35,55,4,28,90,23,32
3515d404,James Ward-Prowse,28,West Ham,Premier League,33.3,1994,MF,22,9,31,18,40.9,44,26,49,0,38,45,8,14,83,23,29
3521abfe,Carlos Dominguez,22,Celta Vigo,La Liga,17.6,2001,DF,12,12,24,23,62.2,37,14,78,0,22,33,7,17,55,9,21
35516eac,Wilson Odobert,18,Burnley,Premier League,23.3,2004,"MF,FW",24,2,26,6,27.3,22,16,14,0,6,17,4,8,23,5,13
356c9002,Antonio Candreva,36,Salernitana,Serie A,30.6,1987,"MF,FW",9,0,9,9,36.0,25,16,23,0,7,18,2,8,25,8,13
357103bd,Fares Chaibi,20,Eint Frankfurt,Bundesliga,21.2,2002,"MF,FW",36,1,37,8,44.4,18,10,19,0,5,27,8,7,32,12,17
35a6e5c7,Gabriel Veiga,21,Celta Vigo,La Liga,0.2,2002,FW,0,0,0,0,"",0,0,0,0,0,0,0,0,0,0,0
35d64857,Tuta,24,Eint Frankfurt,Bundesliga,28.9,1999,DF,17,12,29,39,66.1,59,20,99,0,36,63,6,38,99,19,33
35e413f1,Ben White,25,Arsenal,Premier League,33.2,1997,DF,26,22,48,26,44.8,58,32,77,1,32,48,6,20,80,22,28
35f6db55,Leo Baptistao,30,Almería,La Liga,20.4,1992,FW,12,1,13,9,36.0,25,16,22,0,11,25,5,12,36,8,16
3624ce4c,Victor Diaz,35,Granada,La Liga,1.8,1988,"DF,MF",1,0,1,1,33.3,3,2,8,0,1,5,0,2,6,3,3
3626daea,Leonardo Spinazzola,30,Roma,Serie A,14.6,1993,DF,6,2,8,8,44.4,18,10,15,0,3,15,0,10,18,5,7
36286814,Alberto Risco,17,Getafe,La Liga,1.5,2005,MF,0,0,0,0,0.0,4,4,1,0,0,2,0,1,2,1,2
3649ece2,Niccolo Pierozzi,21,Salernitana,Serie A,9.7,2001,DF,17,7,24,11,50.0,22,11,36,0,11,17,0,13,28,4,11
364e2d13,Andrea Sodero,18,Empoli,Serie A,0.1,2004,MF,0,0,0,0,"",0,0,0,0,0,0,0,0,0,0,0
365113c0,Pubill,20,Almería,La Liga,20.9,2003,DF,12,8,20,22,56.4,39,17,83,1,15,47,4,35,62,8,23
36578017,Yvandro Borges Sanches,19,Gladbach,Bundesliga,0.2,2004,"MF,FW",0,0,0,0,"",0,0,0,0,0,0,0,0,0,0,0
36625c27,Finley Munroe,18,Aston Villa,Premier League,0.0,2005,MF,0,0,0,0,"",0,0,0,0,0,0,0,0,0,0,0
366be751,Nicolo Fagioli,22,Juventus,Serie A,4.9,2001,MF,3,0,3,3,42.9,7,4,1,0,4,5,1,1,9,3,3
3681cfff,Christophe Herelle,30,Metz,Ligue 1,18.0,1992,DF,7,9,16,13,56.5,23,10,68,2,18,32,1,24,50,7,15
36a3ff67,Marco Reus,34,Dortmund,Bundesliga,17.8,1989,"MF,FW",15,2,17,12,44.4,27,15,18,0,5,37,3,20,42,14,25
36a59ba4,Florian Neuhaus,26,Gladbach,Bundesliga,13.6,1997,MF,2,6,8,8,30.8,26,18,8,0,14,15,0,7,29,8,12
36cf2caf,Matej Maglica,24,Darmstadt 98,Bundesliga,18.9,1998,DF,18,11,29,22,61.1,36,14,92,5,22,35,0,25,57,10,21
36f65bdf,Rassoul Ndiaye,21,Le Havre,Ligue 1,5.8,2001,"MF,FW",1,1,2,12,50.0,24,12,5,0,4,25,1,8,29,16,17
3701906c,Pablo Ibanez,24,Osasuna,La Liga,12.8,1998,MF,23,3,26,5,23.8,21,16,17,0,9,18,6,5,27,7,9
3708e9fa,Aleksandr Golovin,27,Monaco,Ligue 1,23.9,1996,"MF,FW",34,3,37,15,35.7,42,27,14,0,21,42,6,14,63,22,30
37118440,Tom Lockyer,28,Luton Town,Premier League,13.0,1994,DF,10,13,23,15,68.2,22,7,68,0,23,25,2,17,48,6,16
37143438,Edan Diop,18,Monaco,Ligue 1,1.8,2004,"MF,DF",3,0,3,7,77.8,9,2,5,0,1,10,1,6,11,3,8
3725b44f,Luc Zogbe,18,Brest,Ligue 1,0.1,2005,DF,0,1,1,0,0.0,1,1,0,0,1,0,0,0,1,0,0
3741ca58,Arda Guler,18,Real Madrid,La Liga,4.2,2005,"FW,MF",0,0,0,5,62.5,8,3,5,0,2,6,2,1,8,3,4
3745e8bd,Sebastian Polter,32,Darmstadt 98,Bundesliga,5.0,1991,FW,4,1,5,0,0.0,1,1,4,0,0,1,0,1,1,0,0
374d5158,Gonzalo Montiel,26,"Nott'ham Forest",Premier League,8.9,1997,DF,5,3,8,16,55.2,29,13,31,1,9,22,2,12,31,8,19
375622c5,Jordan Ferri,31,Montpellier,Ligue 1,22.6,1992,MF,18,1,19,20,29.9,67,47,23,0,13,36,3,16,49,17,22
375ed9d7,Milutin Osmajic,24,Cádiz,La Liga,0.1,1999,MF,0,0,0,0,"",0,0,0,0,0,0,0,0,0,0,0
378825c7,Ramy Bensebaini,28,Dortmund,Bundesliga,11.5,1995,DF,15,7,22,24,70.6,34,10,37,0,16,34,2,21,50,11,21
379652be,Oscar Melendo,25,Granada,La Liga,12.5,1997,"MF,FW",13,0,13,4,33.3,12,8,4,1,5,14,0,4,19,10,6
379dc075,Shon Weissman,27,Granada,La Liga,0.9,1996,FW,3,0,3,1,25.0,4,3,1,0,0,1,1,0,1,0,1
37db6cae,Unai Gomez,20,Athletic Club,La Liga,9.7,2003,MF,11,2,13,5,50.0,10,5,9,0,2,12,4,2,14,6,10
37dc1a48,Jesper Lindstrom,23,Eint Frankfurt,Bundesliga,0.9,2000,FW,0,0,0,0,"",0,0,0,0,0,1,0,1,1,0,1
37e103f8,Hugo Duro,23,Valencia,La Liga,33.1,1999,FW,19,5,24,9,31.0,29,20,27,0,5,16,3,5,21,8,8
37f606f0,Dennis Geiger,25,Hoffenheim,Bundesliga,0.7,1998,MF,0,1,1,0,"",0,0,0,0,0,1,0,1,1,0,0
3828f130,Javier Guerra,20,Valencia,La Liga,27.8,2003,MF,20,7,27,22,37.9,58,36,44,0,18,54,7,25,72,22,24
384d58d9,Denis Zakaria,26,Monaco,Ligue 1,23.7,1996,"MF,DF",26,13,39,12,40.0,30,18,41,0,47,38,7,11,85,20,27
38699c72,Anthony Lozano,30,Almería,La Liga,8.6,1993,FW,5,1,6,4,57.1,7,3,12,0,2,7,0,2,9,5,5
387d06b2,Fred Onyedinma,26,Luton Town,Premier League,4.5,1996,"DF,MF",3,0,3,5,41.7,12,7,13,0,1,10,0,7,11,3,6
38b0cf42,Javier Llabres,20,Mallorca,La Liga,2.7,2002,"MF,FW",1,0,1,1,50.0,2,1,4,0,3,3,1,1,6,1,1
38ce1150,Jorge de Frutos,26,Rayo Vallecano,La Liga,17.2,1997,"FW,MF",12,0,12,7,31.8,22,15,18,0,7,19,6,5,26,8,8
38ceb24a,Leandro Trossard,28,Arsenal,Premier League,18.3,1994,"FW,MF",26,1,27,9,36.0,25,16,6,0,8,27,10,8,35,9,16
3902e91b,Gonzalo Melero,29,Almería,La Liga,12.3,1994,"MF,FW",8,4,12,7,36.8,19,12,11,0,4,14,2,7,18,5,8
3925dbd6,Aleksandar Mitrovic,28,Fulham,Premier League,0.4,1994,FW,0,0,0,0,"",0,0,0,0,0,0,0,0,0,0,0
39352da2,Arnau Puigmal,22,Almería,La Liga,2.8,2001,"FW,DF",3,0,3,1,33.3,3,2,2,0,3,2,0,1,5,1,1
3935e52e,Sead Kolasinac,30,Atalanta,Serie A,24.2,1993,DF,13,9,22,30,61.2,49,19,47,0,21,44,2,23,65,19,32
394854c4,George Baldock,30,Sheffield Utd,Premier League,10.8,1993,DF,6,8,14,6,40.0,15,9,33,0,10,18,1,10,28,7,10
395bbb60,Stefan Schimmer,29,Heidenheim,Bundesliga,1.7,1994,"MF,FW",2,0,2,0,0.0,3,3,6,0,1,1,0,0,2,1,1
3963c25b,Yann Aurel Bisseck,22,Inter,Serie A,10.0,2000,DF,3,7,10,6,66.7,9,3,23,0,5,14,1,10,19,3,6
39769cff,Rasmus Kristensen,26,Roma,Serie A,19.4,1997,DF,20,7,27,28,56.0,50,22,50,0,8,36,3,25,44,8,19
397ba086,Grejohn Kyei,27,Clermont Foot,Ligue 1,11.4,1995,FW,4,1,5,2,66.7,3,1,10,0,1,6,2,2,7,2,4
399e9474,"Amari'i Bell",29,Luton Town,Premier League,19.1,1994,DF,18,15,33,22,62.9,35,13,60,1,25,50,1,30,75,19,33
39b326ed,Gabriel Suazo,25,Toulouse,Ligue 1,26.2,1997,DF,33,4,37,38,44.2,86,48,33,0,26,66,7,40,92,19,32
3a18abe2,Juan Herzog,20,Las Palmas,La Liga,3.2,2003,DF,3,1,4,3,50.0,6,3,17,0,2,6,0,5,8,1,5
3a233281,Leon Bailey,25,Aston Villa,Premier League,23.0,1997,"MF,FW",17,1,18,5,25.0,20,15,6,0,9,13,2,7,22,4,7
3a24769f,Ross Barkley,29,Luton Town,Premier League,29.1,1993,MF,16,9,25,11,22.9,48,37,51,2,25,47,10,16,72,21,19
3a9c4b7b,Nacho Vidal,28,Mallorca,La Liga,4.6,1995,DF,3,2,5,6,46.2,13,7,9,0,3,12,3,4,15,5,5
3aa74860,Hugo Sotelo,19,Celta Vigo,La Liga,8.0,2003,MF,6,1,7,8,40.0,20,12,5,0,2,19,3,3,21,13,17
3aca6420,Tajon Buchanan,24,Inter,Serie A,1.8,1999,DF,1,0,1,1,50.0,2,1,4,0,0,1,1,0,1,0,1
3ad34015,Ebenezer Akinsanmiro,18,Inter,Serie A,0.2,2004,MF,0,0,0,0,0.0,1,1,0,0,0,0,0,0,0,0,0
3b029691,Vitinha,23,Paris S-G,Ligue 1,23.6,2000,MF,18,11,29,16,33.3,48,32,30,2,23,39,11,12,62,16,24
3b12b11f,Alessandro Zanoli,22,Napoli,Serie A,0.6,2000,"DF,FW",0,0,0,0,"",0,0,1,0,1,1,0,1,2,0,1
3b1ed320,Angelo Stiller,22,Stuttgart,Bundesliga,29.9,2001,MF,28,13,41,24,57.1,42,18,25,2,28,55,6,15,83,34,33
3b333ac3,Hans Hateboer,29,Atalanta,Serie A,12.4,1994,DF,14,7,21,5,33.3,15,10,21,0,4,12,2,8,16,2,5
3b387cc7,Gianluca Gaetano,23,Napoli,Serie A,1.8,2000,MF,3,2,5,2,50.0,4,2,4,0,1,4,0,0,5,4,1
3b61c9ec,Luca Pellegrini,24,Lazio,Serie A,8.7,1999,DF,4,3,7,9,52.9,17,8,20,0,9,18,1,7,27,10,13
3b6ace25,Hugo Boutsingkham,20,Nantes,Ligue 1,0.1,2003,"MF,FW",0,0,0,0,"",0,0,1,0,0,0,0,0,0,0,0
3b8674e6,Rodrigo Bentancur,26,Tottenham,Premier League,11.2,1997,MF,11,4,15,10,41.7,24,14,16,1,17,23,2,10,40,11,15
3b88609d,Cher Ndour,19,Paris S-G,Ligue 1,0.3,2004,MF,0,0,0,1,50.0,2,1,0,0,0,2,0,0,2,2,2
3bb625ac,Edimilson Fernandes,27,Mainz 05,Bundesliga,14.3,1996,DF,8,6,14,16,66.7,24,8,52,0,22,25,1,15,47,9,16
3bb7af3b,Riccardo Saponara,31,Hellas Verona,Serie A,3.8,1991,"FW,MF",4,0,4,1,14.3,7,6,2,0,0,3,1,2,3,0,1
3bd65247,Eliesse Ben Seghir,18,Monaco,Ligue 1,4.8,2005,"MF,FW",6,0,6,3,42.9,7,4,2,0,2,9,2,2,11,5,6
3c151571,Marcus Muller,20,Mainz 05,Bundesliga,0.2,2002,MF,0,0,0,0,"",0,0,0,0,0,0,0,0,0,0,0
3c16d927,Alejandro Pozo Pozo,24,Almería,La Liga,10.8,1999,"DF,MF",10,4,14,12,60.0,20,8,21,0,7,19,2,11,26,6,12
3c6089ab,Thomas Muller,33,Bayern Munich,Bundesliga,18.4,1989,"MF,FW",22,0,22,13,37.1,35,22,6,0,3,26,11,5,29,10,16
3c6bbbab,Fabien Centonze,27,Nantes,Ligue 1,1.0,1996,DF,1,1,2,2,66.7,3,1,1,0,0,2,0,2,2,0,1
3ca7254a,Pedro,36,Lazio,Serie A,9.1,1987,"FW,MF",14,2,16,3,25.0,12,9,1,0,3,16,4,5,19,7,12
3cc4bb19,Fali Cande,25,Metz,Ligue 1,20.5,1998,DF,13,28,41,20,57.1,35,15,107,1,20,40,0,31,60,9,19
3cd3b384,Tommaso Augello,28,Cagliari,Serie A,26.9,1994,DF,11,10,21,16,64.0,25,9,89,0,17,26,2,18,43,6,19
3cefcaef,Ferland Mendy,28,Real Madrid,La Liga,19.1,1995,DF,10,2,12,11,78.6,14,3,26,1,13,15,1,12,28,2,10
3d13d9e4,Erik Botheim,23,Salernitana,Serie A,3.5,2000,"FW,MF",3,0,3,0,0.0,1,1,2,0,0,2,0,2,2,0,0
3d50bcdb,Moise Kean,23,Juventus,Serie A,7.3,2000,FW,3,1,4,1,33.3,3,2,5,0,2,7,2,3,9,2,4
3d554589,Hjalmar Ekdal,24,Burnley,Premier League,4.9,1998,DF,5,5,10,2,50.0,4,2,21,0,6,4,0,2,10,2,2
3d79a68c,Francisco Perez,20,Valencia,La Liga,22.8,2002,"MF,FW",19,0,19,15,34.1,44,29,5,0,14,30,6,10,44,14,17
3d7e48ce,Ivan Alejo,28,Cádiz,La Liga,18.8,1995,MF,20,0,20,17,29.8,57,40,17,0,7,40,6,23,47,11,23
3d99999d,Olasagasti,22,Real Sociedad,La Liga,4.0,2000,MF,2,0,2,5,62.5,8,3,5,1,3,16,5,4,19,7,13
3dbdbb6a,Mathias Honsak,26,Darmstadt 98,Bundesliga,11.3,1996,"FW,MF",12,2,14,6,30.0,20,14,25,0,8,14,1,7,22,6,7
3dd738a1,Ruben Aguilar,30,Lens,Ligue 1,21.4,1993,DF,30,5,35,27,60.0,45,18,46,0,26,53,3,27,79,23,31
3e42f707,David Garcia,29,Osasuna,La Liga,25.9,1994,DF,21,19,40,16,61.5,26,10,115,2,18,29,1,19,47,9,18
3e707ad4,Brau,21,Granada,La Liga,0.3,2001,DF,0,0,0,1,100.0,1,0,2,0,0,1,0,1,1,0,0
3e9e06cb,Craig Dawson,33,Wolves,Premier League,24.5,1990,DF,12,39,51,22,64.7,34,12,120,1,16,30,1,23,46,6,20
3ea50f67,Harvey Barnes,25,Newcastle Utd,Premier League,8.9,1997,"FW,MF",1,0,1,1,50.0,2,1,3,0,5,6,1,3,11,2,1
3ead85f9,Alessio Romagnoli,28,Lazio,Serie A,26.8,1995,DF,12,17,29,16,66.7,24,8,115,0,29,25,0,14,54,11,18
3eaf8817,Lebo Mothiba,27,Strasbourg,Ligue 1,6.9,1996,FW,5,1,6,3,75.0,4,1,11,0,0,5,0,1,5,4,2
3eb22ec9,Bernardo Silva,28,Manchester City,Premier League,28.6,1994,"MF,FW",28,4,32,25,43.9,57,32,15,1,17,51,13,13,68,25,23
3ec3c1c9,Lucas Martinez Quarta,27,Fiorentina,Serie A,25.5,1996,DF,24,14,38,36,66.7,54,18,69,4,30,75,4,43,105,28,47
3ecc11d8,Yeray Alvarez,28,Athletic Club,La Liga,12.8,1995,DF,3,5,8,12,63.2,19,7,34,1,11,18,0,15,29,3,9
3ecc8c5f,Mateusz Wieteska,26,Clermont Foot,Ligue 1,1.9,1997,DF,2,2,4,3,60.0,5,2,8,0,5,4,0,3,9,1,1
3ee0dd59,Martin Zubimendi,24,Real Sociedad,La Liga,29.5,1999,MF,24,9,33,23,54.8,42,19,54,0,37,49,2,18,86,29,27
3eeb80e0,Fredrik Jensen,25,Augsburg,Bundesliga,14.9,1997,"MF,FW",29,1,30,14,50.0,28,14,21,0,12,23,6,9,35,8,11
3eed9821,Samuel Umtiti,29,Lille,Ligue 1,2.1,1993,DF,0,0,0,1,25.0,4,3,4,0,2,1,0,0,3,1,1
3eeebc87,Tiago Santos,21,Lille,Ligue 1,26.3,2002,DF,19,5,24,30,57.7,52,22,37,0,15,63,13,31,78,19,42
3effaa34,Andre Silva,27,Real Sociedad,La Liga,8.1,1995,FW,3,0,3,0,0.0,4,4,3,0,1,2,2,0,3,0,2
3f10bd22,Jesus Navas,37,Sevilla,La Liga,22.3,1985,DF,8,7,15,22,55.0,40,18,48,0,22,37,2,21,59,14,27
3f319bb9,Rasmus Nicolaisen,26,Toulouse,Ligue 1,32.5,1997,DF,11,33,44,26,59.1,44,18,158,1,42,50,0,39,92,11,30
3f5f38fb,Nicolo Casale,25,Lazio,Serie A,17.3,1998,DF,3,16,19,6,40.0,15,9,61,0,12,15,0,13,27,2,9
3f79a1c8,Gonzalo Escalante,30,Cádiz,La Liga,18.9,1993,MF,18,5,23,20,36.4,55,35,33,2,26,39,9,16,65,14,24
3f7bafbe,Alejo Veliz,19,Sevilla,La Liga,0.4,2003,FW,0,0,0,1,50.0,2,1,1,0,0,1,0,0,1,1,0
3f7e5a98,Jeppe Corfitzen,18,Lecce,Serie A,0.1,2004,FW,0,0,0,1,100.0,1,0,0,0,0,1,0,0,1,1,0
3fc45c73,Inigo Martinez,32,Barcelona,La Liga,14.4,1991,DF,3,10,13,6,75.0,8,2,50,0,11,10,0,9,21,1,7
3fe6bd8c,Paul Dummett,31,Newcastle Utd,Premier League,0.2,1991,DF,0,0,0,1,100.0,1,0,1,0,0,1,0,1,1,0,0
40221fa7,Bradley Locko,21,Brest,Ligue 1,32.9,2002,DF,27,1,28,47,58.8,80,33,69,0,40,97,6,57,137,34,55
405f267a,Salvi,32,Rayo Vallecano,La Liga,0.3,1991,MF,0,0,0,0,0.0,4,4,0,0,1,0,0,0,1,0,0
405f6586,Milan Duric,33,Monza,Serie A,14.0,1990,FW,4,2,6,2,50.0,4,2,27,0,0,5,0,0,5,5,5
40774c6b,Bamba Dieng,23,Lorient,Ligue 1,6.1,2000,FW,3,0,3,1,33.3,3,2,7,0,0,3,0,0,3,3,3
407feb71,Brahim Diaz,23,Real Madrid,La Liga,17.2,1999,"FW,MF",15,1,16,6,46.2,13,7,2,0,5,29,9,4,34,16,19
41034650,Jurrien Timber,22,Arsenal,Premier League,0.8,2001,DF,1,0,1,0,"",0,0,1,0,0,2,0,1,2,1,2
4125cb98,Jarell Quansah,20,Liverpool,Premier League,13.2,2003,DF,8,8,16,14,70.0,20,6,39,1,17,25,1,17,42,7,22
414184f7,Jhon Duran,19,Aston Villa,Premier League,5.3,2003,"FW,MF",6,0,6,1,16.7,6,5,10,0,1,6,2,3,7,1,5
414e1f69,Marley Ake,22,Udinese,Serie A,0.1,2001,FW,0,0,0,0,"",0,0,0,0,0,0,0,0,0,0,0
41723204,Karol Swiderski,26,Hellas Verona,Serie A,5.6,1997,"FW,MF",2,4,6,2,66.7,3,1,8,0,1,7,3,1,8,3,3
41c12f75,Mathias Olivera,25,Napoli,Serie A,17.4,1997,DF,29,6,35,23,59.0,39,16,25,0,20,50,6,29,70,15,29
41e7ef1c,Layvin Kurzawa,30,Paris S-G,Ligue 1,0.1,1992,DF,0,0,0,0,"",0,0,0,0,0,0,0,0,0,0,0
41eebdf5,Samuel Gigot,29,Marseille,Ligue 1,19.2,1993,DF,10,18,28,13,68.4,19,6,93,1,25,33,4,16,58,13,22
41f08ac8,Keane Lewis-Potter,22,Brentford,Premier League,16.0,2001,"FW,DF",8,2,10,7,46.7,15,8,23,0,7,17,1,5,24,11,7
41f32541,Fernando,36,Sevilla,La Liga,5.1,1987,MF,2,0,2,5,55.6,9,4,9,0,7,9,3,2,16,4,8
41fb0f4e,Domingos Quina,23,Udinese,Serie A,0.1,1999,MF,0,0,0,0,"",0,0,0,0,0,1,0,1,1,0,1
42276181,Kevin Gameiro,36,Strasbourg,Ligue 1,15.0,1987,"FW,MF",9,0,9,2,11.8,17,15,7,0,3,10,2,5,13,3,10
4242011c,Bernardo Espinosa,34,Girona,La Liga,0.0,1989,DF,0,0,0,1,100.0,1,0,2,0,0,1,0,1,1,0,1
42eaa028,Jonathan Ikone,25,Fiorentina,Serie A,18.7,1998,FW,12,0,12,10,58.8,17,7,8,0,3,22,6,7,25,9,11
42f0113f,Stredair Appuah,19,Nantes,Ligue 1,0.9,2004,"FW,MF",0,0,0,0,0.0,3,3,1,0,1,0,0,0,1,0,0
42fd9c7f,Kylian Mbappe,24,Paris S-G,Ligue 1,24.0,1998,FW,4,0,4,4,44.4,9,5,2,0,2,4,2,1,6,1,1
42fdb11d,Frank Magri,23,Toulouse,Ligue 1,16.0,1999,"FW,MF",12,4,16,15,71.4,21,6,17,0,4,22,5,5,26,12,14
431c837b,Klaus Gjasula,33,Darmstadt 98,Bundesliga,15.1,1989,"DF,MF",12,14,26,17,56.7,30,13,42,2,19,44,1,18,63,25,22
43439614,Oliver Norwood,32,Sheffield Utd,Premier League,16.0,1991,MF,15,9,24,20,42.6,47,27,39,0,21,41,5,18,62,18,26
436a9dd0,Ander Herrera,33,Athletic Club,La Liga,11.4,1989,MF,10,6,16,20,55.6,36,16,18,1,15,44,7,11,59,26,32
437f2b00,Christoph Baumgartner,23,RB Leipzig,Bundesliga,12.9,1999,"MF,FW",19,1,20,14,36.8,38,24,14,0,5,26,4,10,31,12,13
43a166b4,Divock Origi,28,"Nott'ham Forest",Premier League,6.7,1995,FW,6,0,6,0,"",0,0,4,0,2,6,1,5,8,0,4
441197b8,"Obite N'Dicka",23,Roma,Serie A,24.1,1999,DF,14,16,30,12,60.0,20,8,75,0,16,32,1,12,48,19,18
44150beb,Jon Pacheco,22,Real Sociedad,La Liga,17.0,2001,DF,11,6,17,14,63.6,22,8,53,1,10,25,0,21,35,4,15
442b56fa,Ridle Baku,25,Wolfsburg,Bundesliga,22.4,1998,"DF,MF",26,1,27,21,45.7,46,25,45,1,21,37,6,24,58,7,20
4431aed2,Ciro Immobile,33,Lazio,Serie A,18.4,1990,FW,6,3,9,3,21.4,14,11,11,0,5,11,4,2,16,5,9
44330c36,Alberto Mari,22,Valencia,La Liga,3.1,2001,FW,3,0,3,1,100.0,1,0,5,0,0,4,3,0,4,1,2
44435c8f,Oumar Diakite,19,Reims,Ligue 1,17.6,2003,FW,13,0,13,7,33.3,21,14,7,0,7,25,6,10,32,9,12
44781702,Ben Davies,30,Tottenham,Premier League,12.1,1993,DF,2,15,17,16,76.2,21,5,35,0,10,24,3,13,34,8,17
44a20f0c,Maximilian Bauer,23,Augsburg,Bundesliga,9.0,2000,DF,6,8,14,9,52.9,17,8,30,1,11,19,2,13,30,4,12
44ac04e9,Matias Vecino,31,Lazio,Serie A,12.8,1991,MF,12,5,17,20,64.5,31,11,21,0,12,32,0,12,44,20,17
44e07fac,Chris Ramos,26,Cádiz,La Liga,29.0,1997,"FW,MF",16,7,23,8,29.6,27,19,44,0,9,28,4,9,37,15,15
44eb9093,"Danilo D'Ambrosio",34,Monza,Serie A,17.1,1988,DF,9,13,22,28,68.3,41,13,31,0,14,57,3,34,71,20,34
4506aec5,Thomas Cannon,20,Everton,Premier League,0.0,2002,FW,0,0,0,0,"",0,0,0,0,0,0,0,0,0,0,0
450ab6fc,Jamaal Lascelles,29,Newcastle Utd,Premier League,12.0,1993,DF,5,12,17,6,54.5,11,5,42,0,5,14,0,7,19,7,9
45191c29,Nicola Zalewski,21,Roma,Serie A,10.8,2002,"DF,FW",8,4,12,8,36.4,22,14,17,0,9,20,1,10,29,9,14
452c3055,Alberto Soro,24,Granada,La Liga,0.1,1999,MF,0,0,0,0,"",0,0,0,0,0,0,0,0,0,0,0
4534a352,Warmed Omari,23,Rennes,Ligue 1,23.0,2000,DF,10,20,30,16,57.1,28,12,77,2,33,32,2,23,65,7,19
45392b06,Nicolas Viola,33,Cagliari,Serie A,13.4,1989,"MF,FW",9,0,9,7,41.2,17,10,6,0,2,13,3,2,15,8,9
454d07c9,Jeremy Jorge,20,Getafe,La Liga,0.0,2003,FW,0,0,0,0,"",0,0,0,0,0,0,0,0,0,0,0
45685411,Jesurun Rak Sakyi,20,Crystal Palace,Premier League,1.5,2002,"MF,FW",2,0,2,2,66.7,3,1,1,0,3,4,0,3,7,1,1
45736cec,Pablo Barrios,20,Atlético Madrid,La Liga,17.3,2003,MF,17,3,20,19,47.5,40,21,24,2,28,45,1,15,73,29,25
4596da74,Evan Ferguson,18,Brighton,Premier League,15.2,2004,FW,7,3,10,5,35.7,14,9,8,0,2,14,3,4,16,7,6
45a03961,Benjamin Pavard,27,Inter,Serie A,18.6,1996,DF,10,15,25,20,83.3,24,4,44,1,32,34,2,21,66,11,21
45af8a54,Marco Asensio,27,Paris S-G,Ligue 1,12.4,1996,"MF,FW",7,0,7,4,30.8,13,9,2,0,5,12,1,4,17,7,10
45b9b619,Joaquin Correa,28,Marseille,Ligue 1,4.8,1994,"FW,MF",2,0,2,0,0.0,8,8,1,0,1,7,1,4,8,2,5
45cce300,Jeffinho,23,Lyon,Ligue 1,3.4,1999,"FW,MF",1,0,1,4,36.4,11,7,0,0,0,11,3,3,11,5,4
45db685d,Jorginho,31,Arsenal,Premier League,10.2,1991,MF,16,1,17,11,47.8,23,12,7,1,12,24,8,6,36,10,10
45e17712,Dimitri Foulquier,30,Valencia,La Liga,20.5,1993,"DF,MF",9,1,10,18,69.2,26,8,49,1,16,39,4,22,55,13,22
45f771db,Tomas Mendes,18,Alavés,La Liga,0.1,2004,MF,0,0,0,0,"",0,0,0,0,0,0,0,0,0,0,0
462475ed,Ludovic Ajorque,29,Mainz 05,Bundesliga,15.1,1994,FW,4,2,6,2,18.2,11,9,11,0,4,3,0,1,7,2,2
4658e309,Aljoscha Kemlein,18,Union Berlin,Bundesliga,0.3,2004,MF,1,0,1,0,0.0,3,3,0,0,0,0,0,0,0,0,0
46750e9c,Nathanael Mbuku,21,Augsburg,Bundesliga,0.1,2002,FW,1,0,1,0,"",0,0,0,0,0,0,0,0,0,0,0
468a7a91,Facundo Buonanotte,18,Brighton,Premier League,15.2,2004,"FW,MF",19,3,22,14,31.8,44,30,5,0,8,42,7,13,50,22,22
468fdbad,Jonas Martin,33,Brest,Ligue 1,13.4,1990,MF,14,2,16,21,58.3,36,15,28,2,9,43,2,17,52,24,27
46e07328,Jose Arnaiz,28,Osasuna,La Liga,10.3,1995,"FW,MF",9,2,11,6,28.6,21,15,2,0,3,14,4,6,17,4,8
47369df8,Josh Brownhill,27,Burnley,Premier League,25.0,1995,MF,25,8,33,27,73.0,37,10,40,1,34,61,10,23,95,28,35
4737cebe,Adnan Januzaj,28,Sevilla,La Liga,2.1,1995,"FW,MF",2,0,2,0,0.0,1,1,0,0,1,3,1,2,4,0,3
473803c9,Nikola Krstovic,23,Lecce,Serie A,26.4,2000,FW,8,4,12,6,60.0,10,4,22,0,4,17,5,3,21,9,6
4788cb6b,Georges Mikautadze,22,Metz,Ligue 1,19.4,2000,FW,11,0,11,0,0.0,9,9,3,0,8,4,1,1,12,2,3
47a34c4f,Mohamed Elneny,31,Arsenal,Premier League,0.3,1992,MF,0,0,0,0,0.0,1,1,0,0,1,0,0,0,1,0,0
47c609d5,El Bilal Toure,21,Atalanta,Serie A,4.4,2001,FW,0,0,0,0,0.0,1,1,2,0,1,1,0,0,2,1,1
47f82561,Emran Soglo,18,Marseille,Ligue 1,1.2,2005,"MF,DF",6,0,6,1,33.3,3,2,3,0,1,2,0,0,3,2,1
48035304,Nico Elvedi,26,Gladbach,Bundesliga,27.6,1996,DF,15,25,40,18,75.0,24,6,150,2,43,33,1,22,76,10,18
481c9ece,Denzel Dumfries,27,Inter,Serie A,18.2,1996,DF,9,6,15,9,39.1,23,14,33,1,12,22,2,9,34,11,13
481f76cf,Josue Casimir,21,Le Havre,Ligue 1,22.4,2001,"FW,DF",21,2,23,7,38.9,18,11,25,0,13,31,3,14,44,14,18
482d2bc3,Lucas Beltran,22,Fiorentina,Serie A,18.8,2001,"FW,MF",26,3,29,11,55.0,20,9,11,0,2,27,5,4,29,18,14
484a3eae,Rodrigo Ribeiro,18,"Nott'ham Forest",Premier League,0.2,2005,"MF,FW",1,0,1,0,0.0,1,1,0,0,1,0,0,0,1,0,0
484ebdb0,Matias Arezo,20,Granada,La Liga,4.1,2002,FW,3,1,4,1,20.0,5,4,4,0,1,7,0,2,8,5,3
48780156,Fabio Chiarodia,18,Gladbach,Bundesliga,1.7,2005,DF,1,1,2,5,71.4,7,2,9,0,3,8,2,5,11,1,5
4887118d,Jordi Mboula,24,Hellas Verona,Serie A,3.4,1999,"FW,MF",3,1,4,4,57.1,7,3,0,0,1,4,1,1,5,2,4
489d4867,Samuel Bamba,19,Dortmund,Bundesliga,0.5,2004,FW,0,0,0,1,50.0,2,1,1,0,0,1,0,1,1,0,1
489e80e3,Mohamed Camara,23,Monaco,Ligue 1,11.5,2000,MF,6,2,8,15,51.7,29,14,7,0,11,35,5,10,46,20,21
48a5a5d6,Gabriel Martinelli,22,Arsenal,Premier League,22.4,2001,FW,22,1,23,13,40.6,32,19,9,1,5,30,9,9,35,12,24
48b3dd60,Arthur Melo,26,Fiorentina,Serie A,22.1,1996,MF,24,3,27,26,61.9,42,16,8,0,18,45,4,17,63,24,30
48d5bd33,Ruslan Malinovskyi,30,Genoa,Serie A,17.2,1993,MF,14,8,22,17,41.5,41,24,16,0,5,35,6,18,40,11,20
49070d66,Lucas Perrin,24,Strasbourg,Ligue 1,30.3,1998,DF,13,32,45,28,60.9,46,18,113,0,28,47,0,33,75,14,30
491a433d,Rasmus Hojlund,20,Manchester Utd,Premier League,24.0,2003,FW,8,1,9,5,38.5,13,8,19,0,1,11,6,2,12,3,7
49296448,Joshua Kimmich,28,Bayern Munich,Bundesliga,24.2,1995,"MF,DF",28,4,32,26,66.7,39,13,28,1,14,45,5,25,59,15,33
493924a7,Kevin Mbabu,28,Augsburg,Bundesliga,22.7,1995,DF,20,9,29,23,57.5,40,17,48,0,24,51,8,25,75,18,39
4958bfb2,Dani Carvajal,31,Real Madrid,La Liga,24.1,1992,DF,19,9,28,23,54.8,42,19,54,4,22,47,4,28,69,15,32
496aeede,Christoph Kramer,32,Gladbach,Bundesliga,2.8,1991,MF,6,1,7,2,14.3,14,12,6,0,4,10,0,5,14,5,5
49a6ecbb,Alvaro Munoz,19,Real Madrid,La Liga,0.0,2004,FW,0,0,0,0,"",0,0,1,0,0,0,0,0,0,0,0
49d028db,Edgar Gonzalez,26,Almería,La Liga,28.0,1997,"DF,MF",20,28,48,25,51.0,49,24,130,3,38,45,3,22,83,20,21
49dbab27,Isaac Palazon Camacho,28,Rayo Vallecano,La Liga,31.0,1994,"MF,FW",27,2,29,20,34.5,58,38,41,0,16,46,9,16,62,21,25
49fe9070,Timo Werner,27,RB Leipzig,Bundesliga,2.3,1996,"FW,MF",1,0,1,0,"",0,0,0,0,1,2,1,0,3,1,1
4a1a9578,Luis Diaz,26,Liverpool,Premier League,29.2,1997,FW,15,0,15,7,23.3,30,23,8,0,3,35,13,5,38,17,25
4a478107,Jose Luis Morales,36,Villarreal,La Liga,11.6,1987,"FW,MF",8,1,9,3,23.1,13,10,4,0,7,5,0,1,12,4,3
4a56052c,Jordan Veretout,30,Marseille,Ligue 1,24.3,1993,MF,16,4,20,18,46.2,39,21,25,0,13,38,6,19,51,13,22
4a5a45c7,Lorenzo Pellegrini,27,Roma,Serie A,20.7,1996,MF,23,5,28,17,33.3,51,34,22,0,20,35,5,14,55,16,20
4a633cfe,Unai Garcia,31,Osasuna,La Liga,6.2,1992,DF,6,1,7,5,50.0,10,5,18,0,8,12,1,9,20,2,9
4a987ffa,Adrian Grbic,26,Lorient,Ligue 1,0.3,1996,FW,0,0,0,0,"",0,0,0,0,0,0,0,0,0,0,0
4ab53cdb,Jay Rodriguez,34,Burnley,Premier League,9.1,1989,FW,10,1,11,7,53.8,13,6,8,0,1,14,3,7,15,4,9
4abac767,Carlos Alcaraz,20,Juventus,Serie A,4.2,2002,MF,3,2,5,5,50.0,10,5,4,0,5,6,0,0,11,6,6
4accb7e0,Darko Brasanac,31,Osasuna,La Liga,0.5,1992,MF,1,0,1,1,100.0,1,0,0,0,0,1,0,1,1,0,0
4acd733a,Valery Fernandez,23,Girona,La Liga,5.6,1999,"MF,FW",5,1,6,6,75.0,8,2,4,0,1,11,0,4,12,7,9
4ae67f27,Alessandro Buongiorno,24,Torino,Serie A,28.1,1999,DF,8,12,20,24,70.6,34,10,131,0,69,70,3,43,139,24,39
4aea5077,Stefan Lainer,30,Gladbach,Bundesliga,8.3,1992,"DF,MF",7,6,13,14,58.3,24,10,28,0,5,23,0,15,28,8,16
4b029b31,Edoardo Goldaniga,29,Cagliari,Serie A,11.2,1993,DF,4,7,11,4,40.0,10,6,37,1,15,12,0,9,27,3,7
4b3e1a38,Amir Rrahmani,29,Napoli,Serie A,28.9,1994,DF,14,10,24,16,50.0,32,16,90,0,20,33,2,17,53,14,27
4b511457,Oriol Romeu,31,Barcelona,La Liga,10.4,1991,MF,10,2,12,13,54.2,24,11,18,0,10,34,3,17,44,14,20
4b542852,Adam Wharton,19,Crystal Palace,Premier League,14.4,2004,MF,14,3,17,23,50.0,46,23,24,1,20,48,8,18,68,22,32
4b803b3c,Maximilian Wober,25,Gladbach,Bundesliga,23.0,1998,DF,21,26,47,31,58.5,53,22,111,0,38,66,1,40,104,25,31
4b96c347,Angelo Fulgini,26,Lens,Ligue 1,15.3,1996,MF,21,1,22,11,57.9,19,8,11,0,8,23,4,6,31,13,14
4bcf39f6,Neal Maupay,26,Everton,Premier League,1.2,1996,FW,2,0,2,0,0.0,1,1,1,0,0,0,0,0,0,0,0
4bd414c1,Raul Albiol,37,Villarreal,La Liga,22.6,1985,DF,7,24,31,18,66.7,27,9,102,0,16,25,1,15,41,9,14
4c0a6a48,Jon Guridi,28,Alavés,La Liga,29.8,1995,MF,20,3,23,12,26.7,45,33,22,0,22,42,5,10,64,27,24
4c2e9442,Maxi Gomez,26,Cádiz,La Liga,12.9,1996,FW,5,3,8,3,60.0,5,2,3,0,3,6,1,2,9,3,4
4c3a6744,Justin Kluivert,24,Bournemouth,Premier League,21.3,1999,"MF,FW",15,1,16,8,26.7,30,22,11,0,8,28,11,5,36,12,14
4c5835e6,Benicio Boaitey,19,Brighton,Premier League,0.4,2004,"FW,DF",1,0,1,0,0.0,1,1,2,0,0,0,0,0,0,0,0
4c6facae,Djibril Sow,26,Sevilla,La Liga,16.2,1997,MF,17,3,20,9,36.0,25,16,8,1,17,28,5,15,45,8,21
4c8845f7,Youssef Maleh,24,Empoli,Serie A,28.9,1998,MF,55,7,62,23,44.2,52,29,29,0,25,74,8,30,99,36,48
4ccd8957,Eren Dinkci,21,Heidenheim,Bundesliga,29.4,2001,"FW,MF",36,4,40,19,39.6,48,29,21,0,12,32,3,16,44,13,18
4cd41883,Paxten Aaronson,19,Eint Frankfurt,Bundesliga,1.1,2003,MF,2,0,2,1,100.0,1,0,0,0,0,2,0,1,2,1,2
4cdcbc14,Filip Jagiello,25,Genoa,Serie A,0.4,1997,MF,0,1,1,0,0.0,1,1,0,0,1,0,0,0,1,0,0
4d1666ff,Jules Kounde,24,Barcelona,La Liga,32.2,1998,DF,20,12,32,28,54.9,51,23,83,5,25,37,5,22,62,10,23
4d224fe8,Casemiro,31,Manchester Utd,Premier League,22.0,1992,"MF,DF",41,33,74,51,48.1,106,55,71,1,18,83,8,43,101,32,56
4d753a3f,Raul Torrente,21,Granada,La Liga,13.9,2001,DF,6,10,16,17,77.3,22,5,68,2,11,29,0,20,40,9,16
4d77b365,Darwin Nunez,24,Liverpool,Premier League,22.7,1999,FW,12,6,18,11,47.8,23,12,9,0,3,22,10,2,25,10,12
4d8cd038,Luka Jovic,25,Milan,Serie A,9.7,1997,FW,3,0,3,4,66.7,6,2,9,0,1,6,3,0,7,3,4
4dbd0916,Thomas Lemar,27,Atlético Madrid,La Liga,1.8,1995,MF,0,0,0,1,50.0,2,1,0,0,0,3,0,2,3,1,1
4dcec659,Simon Adingra,21,Brighton,Premier League,24.7,2002,FW,30,1,31,19,45.2,42,23,22,0,19,45,11,23,64,11,20
4e015693,James Garner,22,Everton,Premier League,33.4,2001,MF,31,14,45,35,42.7,82,47,47,1,45,83,13,32,128,38,44
4e1d5e59,Szymon Zurkowski,25,Empoli,Serie A,9.6,1997,MF,4,1,5,5,33.3,15,10,11,0,6,15,2,5,21,8,6
4e204552,Jacob Bruun Larsen,24,Burnley,Premier League,13.9,1998,"MF,FW",14,2,16,7,33.3,21,14,23,0,7,9,2,4,16,3,4
4e219ad2,Suso,29,Sevilla,La Liga,16.9,1993,"MF,FW",9,0,9,8,28.6,28,20,4,0,5,24,2,14,29,8,17
4e358a2d,Federico Fazio,36,Salernitana,Serie A,15.1,1987,DF,3,19,22,8,57.1,14,6,99,1,17,18,0,14,35,4,11
4e5a4cbc,Scott McKenna,26,"Nott'ham Forest",Premier League,4.6,1996,DF,2,4,6,2,66.7,3,1,27,0,5,4,0,3,9,1,0
4e9a0555,Chris Wood,31,"Nott'ham Forest",Premier League,20.1,1991,FW,8,3,11,3,33.3,9,6,26,0,1,7,2,1,8,4,4
4f16405e,Niclas Fullkrug,30,Dortmund,Bundesliga,24.6,1993,FW,13,4,17,2,25.0,8,6,25,0,2,7,0,1,9,6,2
4f255115,Aurelien Tchouameni,23,Real Madrid,La Liga,22.1,2000,"MF,DF",8,13,21,9,50.0,18,9,52,1,28,38,2,19,66,17,23
4f28a6ff,Clement Lenglet,28,Aston Villa,Premier League,12.8,1995,DF,8,11,19,7,53.8,13,6,47,1,7,13,1,7,20,5,9
4f565d77,Kalvin Phillips,27,Manchester City,Premier League,1.0,1995,MF,0,0,0,0,"",0,0,2,0,2,3,1,1,5,1,3
4f96ed39,Isak Hansen-Aaroen,18,Werder Bremen,Bundesliga,0.3,2004,MF,1,0,1,0,0.0,1,1,0,0,1,0,0,0,1,0,0
4f974391,Aaron Cresswell,33,West Ham,Premier League,4.8,1989,"DF,FW",2,3,5,2,66.7,3,1,7,0,3,3,1,1,6,1,2
4fb7cc15,Andres Sfait,18,Salernitana,Serie A,0.3,2004,"DF,MF",0,0,0,1,50.0,2,1,0,0,0,1,0,1,1,0,1
4fb9c88f,Curtis Jones,22,Liverpool,Premier League,13.0,2001,MF,22,0,22,10,43.5,23,13,8,0,7,27,3,12,34,12,14
4fd08daa,Jan Paul van Hecke,23,Brighton,Premier League,26.3,2000,DF,22,27,49,27,60.0,45,18,76,4,30,47,3,25,77,19,26
4fe2648c,Aaron Malouda,17,Lille,Ligue 1,0.0,2005,FW,0,0,0,0,"",0,0,0,0,0,0,0,0,0,0,0
501055d8,Karim Adeyemi,21,Dortmund,Bundesliga,10.1,2002,"FW,MF",11,0,11,8,40.0,20,12,5,0,3,16,3,9,19,4,14
505486d6,Victor Bernth Kristiansen,20,Bologna,Serie A,25.6,2002,DF,27,8,35,20,57.1,35,15,45,1,12,52,7,23,64,22,34
5069b796,Achraf Dari,24,Brest,Ligue 1,1.3,1999,"DF,FW",2,0,2,0,0.0,2,2,9,1,5,1,0,1,6,0,1
506daeac,Antonio Blanco,23,Alavés,La Liga,27.0,2000,MF,23,2,25,31,36.0,86,55,30,0,35,61,5,29,96,27,36
507c7bdf,Bruno Fernandes,28,Manchester Utd,Premier League,34.6,1994,"MF,FW",43,6,49,30,34.1,88,58,50,2,27,68,16,27,95,25,38
5083a734,Yangel Herrera,25,Girona,La Liga,23.4,1998,MF,22,8,30,30,53.6,56,26,45,1,24,64,6,28,88,30,37
50871bcc,Thorgan Hazard,30,Dortmund,Bundesliga,0.1,1993,DF,0,0,0,0,"",0,0,0,0,0,0,0,0,0,0,0
508a9011,Mohamed El Arouch,19,Lyon,Ligue 1,0.0,2004,FW,0,0,0,0,"",0,0,0,0,0,0,0,0,0,0,0
50dc94ce,Donny van de Beek,26,Eint Frankfurt,Bundesliga,4.0,1997,"MF,FW",4,1,5,3,42.9,7,4,1,0,3,8,2,3,11,3,3
50e6dc35,Jean-Philippe Mateta,26,Crystal Palace,Premier League,25.4,1997,FW,9,4,13,6,60.0,10,4,14,0,4,22,7,4,26,11,15
50ff205b,Attila Szalai,25,Freiburg,Bundesliga,1.1,1998,DF,3,2,5,1,50.0,2,1,11,1,1,1,0,1,2,0,1
5128bde4,Darko Lazovic,32,Hellas Verona,Serie A,21.4,1990,"FW,MF",9,1,10,16,51.6,31,15,14,0,6,26,9,11,32,6,16
514270e8,Youssef Maziz,25,Metz,Ligue 1,1.4,1998,"FW,MF",1,0,1,0,0.0,2,2,2,0,1,0,0,0,1,0,0
5148dcc5,Martin Terrier,26,Rennes,Ligue 1,17.0,1997,"FW,MF",17,4,21,6,42.9,14,8,17,0,9,14,3,3,23,8,9
5167c97e,Massadio Haidara,30,Lens,Ligue 1,8.2,1992,DF,5,2,7,4,66.7,6,2,32,3,11,9,1,5,20,3,8
517cfb19,Mohamed Kaba,21,Lecce,Serie A,15.3,2001,MF,18,4,22,17,50.0,34,17,13,0,12,39,8,15,51,16,23
518f2234,Alex Baena,22,Villarreal,La Liga,28.7,2001,"MF,FW",21,2,23,20,42.6,47,27,17,1,13,34,8,10,47,16,21
51a3c4c8,Felipe,34,"Nott'ham Forest",Premier League,4.2,1989,DF,3,1,4,9,75.0,12,3,12,0,4,12,0,9,16,3,9
51c30111,Sanjin Prcic,29,Strasbourg,Ligue 1,1.0,1993,MF,1,1,2,0,0.0,1,1,1,0,3,0,0,0,3,0,0
51cf8561,Oleksandr Zinchenko,26,Arsenal,Premier League,19.1,1996,DF,15,3,18,35,67.3,52,17,26,2,20,50,7,19,70,24,30
51d29173,Frank Ronstadt,26,Darmstadt 98,Bundesliga,0.8,1997,"DF,MF",1,0,1,0,0.0,1,1,3,0,1,1,0,0,2,1,0
51dbeea9,Thilo Kehrer,26,Monaco,Ligue 1,14.7,1996,DF,12,6,18,22,56.4,39,17,55,0,30,32,3,22,62,7,22
5219ab4a,Jonathan Clauss,30,Marseille,Ligue 1,23.0,1992,DF,14,3,17,26,53.1,49,23,46,0,36,47,6,22,83,19,20
526ea7cc,Amos Pieper,25,Werder Bremen,Bundesliga,6.6,1998,DF,5,7,12,7,53.8,13,6,36,1,9,14,0,8,23,6,11
5271c8f1,Benjamin Mendy,29,Lorient,Ligue 1,7.9,1994,DF,6,2,8,1,20.0,5,4,20,0,7,3,0,2,10,1,1
528492ea,Alfred Duncan,30,Fiorentina,Serie A,21.0,1993,MF,22,5,27,15,42.9,35,20,13,0,11,35,7,13,46,15,22
5294a83f,Luis Alberto,30,Lazio,Serie A,25.7,1992,MF,30,4,34,15,28.3,53,38,13,0,7,35,7,16,42,12,20
529f49ab,Thomas Partey,30,Arsenal,Premier League,8.8,1993,"MF,DF",6,3,9,5,50.0,10,5,9,0,11,14,1,9,25,4,11
52afb588,Kevin Schade,21,Brentford,Premier League,3.7,2001,"FW,MF",2,0,2,0,0.0,5,5,4,0,1,3,0,1,4,2,1
52ec54d0,Leonardo Bonucci,36,Union Berlin,Bundesliga,5.1,1987,DF,2,3,5,4,100.0,4,0,16,0,7,6,0,2,13,4,5
532e1e4f,Pau Torres,26,Aston Villa,Premier League,27.4,1997,DF,16,12,28,14,46.7,30,16,75,0,14,29,1,17,43,11,18
53552942,Maximo Perrone,20,Las Palmas,La Liga,18.0,2003,MF,23,4,27,19,48.7,39,20,21,0,24,42,3,17,66,22,21
535b0343,Alois Confais,26,Le Havre,Ligue 1,0.1,1996,"MF,FW",0,0,0,1,100.0,1,0,0,0,0,2,0,1,2,1,2
53a0e358,Domenico Berardi,28,Sassuolo,Serie A,15.9,1994,FW,17,0,17,2,9.5,21,19,9,0,13,17,1,7,30,9,8
53cad200,Cesar Azpilicueta,33,Atlético Madrid,La Liga,15.8,1989,DF,19,6,25,12,63.2,19,7,46,0,16,25,1,15,41,9,14
540ec57b,Yeremi Pino,20,Villarreal,La Liga,5.3,2002,"MF,FW",10,1,11,9,50.0,18,9,5,0,5,25,3,12,30,10,18
5418d47c,Fabio Gonzalez,26,Las Palmas,La Liga,1.4,1997,MF,2,0,2,1,50.0,2,1,0,0,0,2,0,2,2,0,2
546bb36e,Bonke Innocent,27,Lorient,Ligue 1,2.3,1996,MF,1,1,2,2,22.2,9,7,2,0,4,6,2,2,10,2,4
546c7f68,Gino Infantino,20,Fiorentina,Serie A,1.1,2003,MF,4,0,4,0,0.0,1,1,1,0,3,1,0,0,4,1,1
54778940,Dominic Sadi,19,Bournemouth,Premier League,0.0,2003,FW,0,0,0,0,"",0,0,0,0,0,0,0,0,0,0,0
547a72ad,Julien Le Cardinal,25,Lens,Ligue 1,0.6,1997,DF,1,1,2,4,44.4,9,5,0,0,0,6,0,4,6,2,2
547c0119,Alan Matturro,18,Genoa,Serie A,1.2,2004,DF,3,3,6,1,100.0,1,0,4,0,2,1,0,1,3,0,1
548756f2,Mohamed Bechikh,18,Strasbourg,Ligue 1,0.2,2005,"FW,MF",0,0,0,0,"",0,0,0,0,0,0,0,0,0,0,0
5487adcd,Abdul Mumin,25,Rayo Vallecano,La Liga,18.8,1998,DF,8,19,27,8,80.0,10,2,82,1,22,19,2,13,41,4,10
548bd0de,Gvidas Gineitis,19,Torino,Serie A,6.0,2004,MF,6,4,10,4,57.1,7,3,9,1,4,11,0,3,15,8,7
5496cc91,Alberto Perea,32,Granada,La Liga,0.0,1990,"MF,FW",0,0,0,0,0.0,2,2,0,0,0,0,0,0,0,0,0
54d2b378,Elias Baum,17,Eint Frankfurt,Bundesliga,0.3,2005,"DF,MF",1,2,3,0,"",0,0,1,0,0,1,1,0,1,0,0
54e4866f,Vincenzo Grifo,30,Freiburg,Bundesliga,25.8,1993,"MF,FW",21,1,22,14,45.2,31,17,20,0,15,31,6,14,46,11,20
54e53b7e,Gianluca Caprari,30,Monza,Serie A,3.2,1993,"MF,FW",0,0,0,0,0.0,1,1,0,0,2,2,0,1,4,1,1
55126f3b,Koke,31,Atlético Madrid,La Liga,27.7,1992,MF,25,12,37,36,45.6,79,43,34,1,16,66,7,27,82,32,44
5515376c,Trevoh Chalobah,24,Chelsea,Premier League,10.6,1999,DF,1,7,8,10,66.7,15,5,51,0,8,16,4,10,24,2,12
5521f419,Adam Hlozek,21,Leverkusen,Bundesliga,5.1,2002,"MF,FW",3,1,4,3,42.9,7,4,1,0,2,10,4,2,12,4,4
5526deb1,Tommy Doyle,21,Wolves,Premier League,13.6,2001,MF,13,9,22,14,60.9,23,9,18,0,12,26,5,11,38,10,13
554bcc91,Arne Engels,19,Augsburg,Bundesliga,15.6,2003,"MF,DF",22,1,23,12,41.4,29,17,21,0,15,33,4,15,48,14,18
5556d20b,Jordi,22,Getafe,La Liga,6.4,2001,"MF,DF",5,2,7,7,46.7,15,8,7,0,8,16,2,3,24,11,11
555d5edd,Nadiem Amiri,26,Leverkusen,Bundesliga,1.0,1996,MF,0,0,0,0,0.0,3,3,1,0,0,4,1,0,4,3,2
555f3a0b,Mario Hermoso,28,Atlético Madrid,La Liga,28.4,1995,DF,18,9,27,28,54.9,51,23,93,0,30,46,4,29,76,13,25
55634fb8,Kaiky,19,Almería,La Liga,5.8,2004,DF,2,7,9,3,50.0,6,3,29,1,3,7,1,6,10,0,4
55a1cac2,Tommaso Pobega,24,Milan,Serie A,3.5,1999,MF,8,2,10,6,46.2,13,7,7,0,6,16,0,11,22,5,9
55abe554,Clinton Mata,30,Lyon,Ligue 1,24.7,1992,DF,19,16,35,23,57.5,40,17,61,0,40,43,6,29,83,8,24
562a4799,Boubakar Kouyate,26,Montpellier,Ligue 1,21.4,1997,DF,11,20,31,28,54.9,51,23,123,1,29,49,2,39,78,8,30
5680bf3f,Jeremie Bela,30,Clermont Foot,Ligue 1,2.3,1993,"MF,FW",1,0,1,1,33.3,3,2,1,0,0,1,0,0,1,1,1
56cafd0a,Miguel Angel Rubio,25,Granada,La Liga,17.3,1998,DF,13,18,31,14,66.7,21,7,74,2,28,20,0,14,48,6,12
56f7a928,Youri Tielemans,26,Aston Villa,Premier League,18.0,1997,"MF,FW",20,3,23,16,40.0,40,24,9,0,15,41,6,17,56,18,20
56fca564,Daniel Bandeira,23,Hellas Verona,Serie A,5.0,2000,MF,3,0,3,3,42.9,7,4,9,0,3,6,1,1,9,4,5
570bb4b9,Hamed Junior Traore,23,Napoli,Serie A,4.2,2000,MF,3,0,3,1,16.7,6,5,1,1,2,4,2,2,6,0,2
5715bb71,Gustav Isaksen,22,Lazio,Serie A,11.9,2001,FW,10,1,11,1,11.1,9,8,4,0,4,4,1,2,8,1,3
57382429,Jan-Niklas Beste,24,Heidenheim,Bundesliga,28.9,1999,"FW,MF",47,1,48,28,50.9,55,27,31,0,18,77,18,35,95,24,49
57469b2d,Eldor Shomurodov,28,Cagliari,Serie A,10.4,1995,"FW,MF",5,0,5,6,60.0,10,4,4,0,4,11,3,2,15,6,4
575b1a7b,Enzo Mongo,18,Nantes,Ligue 1,0.1,2005,DF,0,1,1,1,50.0,2,1,0,0,1,1,0,1,2,0,1
5762be5c,Atakan Karazor,26,Stuttgart,Bundesliga,29.1,1996,MF,29,8,37,29,48.3,60,31,43,0,27,72,11,23,99,38,44
576817b7,Jaouen Hadjam,20,Nantes,Ligue 1,1.2,2003,DF,0,0,0,1,50.0,2,1,2,0,3,6,0,5,9,1,4
576ca93f,Djaoui Cisse,19,Rennes,Ligue 1,0.0,2004,MF,0,0,0,0,"",0,0,0,0,0,0,0,0,0,0,0
57827369,Ben Brereton,24,Villarreal,La Liga,3.0,1999,"FW,MF",0,0,0,0,0.0,2,2,0,0,0,2,1,1,2,0,2
57be54ec,Asier Villalibre,25,Athletic Club,La Liga,5.7,1997,FW,1,1,2,2,100.0,2,0,6,0,0,2,2,0,2,0,1
57c94db2,Mads Roerslev,24,Brentford,Premier League,22.1,1999,DF,12,3,15,27,50.0,54,27,71,0,19,48,5,34,67,9,31
57d88cf9,Jude Bellingham,20,Real Madrid,La Liga,25.7,2003,MF,50,5,55,12,33.3,36,24,17,0,21,42,10,14,63,18,34
57d9f511,Nikola Dovedan,29,Heidenheim,Bundesliga,7.3,1994,"MF,FW",9,0,9,5,20.0,25,20,3,0,1,14,2,2,15,10,9
57ec75bf,Tim Oermann,19,Bochum,Bundesliga,7.9,2003,DF,9,6,15,9,64.3,14,5,22,0,2,19,4,11,21,4,11
582a5247,Mads Pedersen,26,Augsburg,Bundesliga,19.8,1996,DF,17,3,20,24,54.5,44,20,46,0,19,64,6,31,83,27,39
58468842,Nacho Ferri,18,Eint Frankfurt,Bundesliga,0.8,2004,"FW,MF",0,0,0,2,66.7,3,1,2,0,0,3,0,1,3,2,3
5853ac44,Tanguy Nianzou,21,Sevilla,La Liga,3.5,2002,DF,2,0,2,8,72.7,11,3,9,1,3,12,1,9,15,2,8
58a9a4d9,Oliver Torres,28,Sevilla,La Liga,18.0,1994,MF,36,4,40,22,38.6,57,35,6,0,6,37,5,17,43,15,22
58aae0a9,Faris Pemi Moumbagna,23,Marseille,Ligue 1,6.1,2000,FW,4,0,4,0,0.0,3,3,1,0,3,2,0,0,5,2,1
58afe001,Mauro Arambarri,27,Getafe,La Liga,3.8,1995,MF,1,0,1,1,16.7,6,5,7,0,2,6,1,3,8,2,2
58e08f40,Leonardo Cerri,20,Juventus,Serie A,0.1,2003,DF,0,0,0,0,"",0,0,0,0,0,0,0,0,0,0,0
58e933d2,Christian Kouame,25,Fiorentina,Serie A,12.1,1997,FW,16,0,16,6,60.0,10,4,10,0,2,13,0,7,15,6,4
58eee997,Mason Greenwood,21,Getafe,La Liga,29.6,2001,"MF,FW",9,0,9,4,19.0,21,17,4,0,4,11,3,3,15,5,6
591bf874,Agustin Martegani,23,Salernitana,Serie A,8.1,2000,MF,3,1,4,6,33.3,18,12,7,1,4,13,3,7,17,3,7
592f3158,Oscar Valentin,28,Rayo Vallecano,La Liga,29.9,1994,MF,52,10,62,46,45.5,101,55,52,1,35,107,6,39,142,62,66
5939baa2,Benjamin Stambouli,32,Reims,Ligue 1,3.2,1990,MF,2,1,3,6,54.5,11,5,8,0,2,9,1,3,11,5,7
595e6f3e,Mostafa Mohamed,25,Nantes,Ligue 1,22.2,1997,FW,16,5,21,6,21.4,28,22,29,0,12,21,3,7,33,11,14
596cc50e,Marcus Pedersen,23,Sassuolo,Serie A,17.9,2000,DF,14,5,19,21,84.0,25,4,51,0,10,36,6,25,46,5,24
59878425,Marquinhos,20,Nantes,Ligue 1,1.7,2003,"FW,MF",5,2,7,1,25.0,4,3,1,0,6,3,1,2,9,0,2
59948ef7,David Pereira da Costa,22,Lens,Ligue 1,16.6,2001,MF,17,4,21,10,43.5,23,13,8,1,16,18,1,5,34,12,10
599d91d0,Michel Ndary Adopo,23,Atalanta,Serie A,1.2,2000,MF,0,0,0,1,100.0,1,0,2,1,0,4,1,0,4,3,3
59b7d823,Inigo Lekue,30,Athletic Club,La Liga,22.2,1993,DF,18,6,24,27,50.9,53,26,50,0,15,40,5,25,55,10,22
59bf127b,Tiemoue Bakayoko,28,Lorient,Ligue 1,14.6,1994,MF,6,4,10,15,53.6,28,13,15,1,26,34,3,14,60,17,17
59c29820,Cesar Tarrega,21,Valencia,La Liga,0.1,2002,DF,0,0,0,0,"",0,0,2,0,0,0,0,0,0,0,0
59e4b92e,Rani Khedira,29,Union Berlin,Bundesliga,14.9,1994,MF,7,5,12,17,65.4,26,9,38,0,22,35,1,15,57,19,22
59e6e5bf,Dominic Calvert-Lewin,26,Everton,Premier League,24.1,1997,FW,10,4,14,2,13.3,15,13,38,0,4,13,5,2,17,6,6
59fcbd6d,Danley Jean-Jacques,23,Metz,Ligue 1,29.8,2000,MF,41,7,48,19,33.9,56,37,44,0,44,54,9,24,98,21,28
5a04fd92,Said Benrahma,27,Lyon,Ligue 1,8.6,1995,"FW,MF",7,0,7,5,71.4,7,2,3,0,1,9,2,1,10,6,7
5a08ee41,Federico Baschirotto,26,Lecce,Serie A,36.6,1996,DF,16,26,42,8,53.3,15,7,144,1,23,21,0,16,44,5,12
5a2cb25d,Sofyan Amrabat,26,Manchester Utd,Premier League,10.4,1996,"MF,DF",13,7,20,17,54.8,31,14,19,2,8,27,2,17,35,8,16
5a626448,Moi Gomez,29,Osasuna,La Liga,22.3,1994,"MF,FW",14,1,15,9,37.5,24,15,22,0,11,30,4,7,41,19,19
5a7301ae,Leander Dendoncker,28,Napoli,Serie A,0.3,1995,MF,0,1,1,0,"",0,0,0,0,0,0,0,0,0,0,0
5aa53281,Gianluca Mancini,27,Roma,Serie A,31.9,1996,DF,12,26,38,11,40.7,27,16,77,1,36,34,2,21,70,11,20
5acc4a10,Etienne Capoue,35,Villarreal,La Liga,16.2,1988,MF,16,4,20,15,68.2,22,7,24,1,22,32,3,17,54,12,18
5ad50391,Josko Gvardiol,21,Manchester City,Premier League,25.9,2002,DF,24,12,36,21,55.3,38,17,37,3,27,55,10,21,82,24,33
5ae499d0,Santi Comesana,26,Villarreal,La Liga,18.4,1996,MF,24,9,33,19,50.0,38,19,27,1,22,44,8,15,66,21,26
5b146df3,Lilian Brassier,23,Brest,Ligue 1,29.7,1999,DF,7,21,28,12,50.0,24,12,93,0,41,31,0,18,72,13,18
5b418e15,Sydney van Hooijdonk,23,Bologna,Serie A,2.4,2000,FW,0,1,1,1,50.0,2,1,4,0,1,3,1,0,4,2,0
5b479568,Myron Boadu,22,Monaco,Ligue 1,0.9,2001,FW,2,0,2,1,50.0,2,1,0,0,0,2,1,0,2,1,2
5b847bb0,Artem Dovbyk,26,Girona,La Liga,28.7,1997,FW,7,1,8,0,0.0,2,2,17,0,0,4,1,2,4,1,3
5b92d896,Hugo Ekitike,21,Eint Frankfurt,Bundesliga,8.0,2002,FW,10,0,10,4,66.7,6,2,4,0,2,11,2,3,13,6,7
5b9512c5,Castello Lukeba,20,RB Leipzig,Bundesliga,24.3,2002,DF,22,13,35,10,83.3,12,2,94,2,12,19,0,10,31,9,12
5bc43860,Brenden Aaronson,22,Union Berlin,Bundesliga,14.1,2000,"MF,FW",25,1,26,16,50.0,32,16,4,0,2,32,6,13,34,13,18
5bd72174,Francesco Caputo,35,Empoli,Serie A,14.1,1987,FW,4,0,4,0,0.0,1,1,3,0,1,2,2,0,3,0,0
5bdb4a7b,Othmane Maamma,17,Montpellier,Ligue 1,1.0,2005,FW,3,0,3,1,100.0,1,0,0,0,0,3,1,2,3,0,3
5c0da4a4,Marcus Tavernier,24,Bournemouth,Premier League,23.5,1999,FW,28,3,31,26,54.2,48,22,23,0,5,53,6,25,58,22,34
5c26ca51,Teddy Teuma,29,Reims,Ligue 1,23.5,1993,MF,29,4,33,25,40.3,62,37,6,0,20,54,14,19,74,21,36
5c2b4f07,Serge Aurier,30,"Nott'ham Forest",Premier League,9.3,1992,"DF,MF",7,3,10,5,45.5,11,6,36,1,9,20,0,9,29,11,14
5c368c88,Ethan Wheatley,17,Manchester Utd,Premier League,0.2,2006,FW,2,0,2,1,100.0,1,0,0,0,2,1,0,0,3,1,1
5c4dc0ff,Mariano,29,Sevilla,La Liga,2.7,1993,"FW,MF",1,0,1,0,0.0,1,1,2,0,0,1,0,0,1,1,1
5c50fdbc,Kevin Paredes,20,Wolfsburg,Bundesliga,15.9,2003,"FW,MF",25,2,27,20,58.8,34,14,26,0,23,42,7,22,65,13,21
5c7845f6,Igor Zubeldia,26,Real Sociedad,La Liga,28.0,1997,DF,9,19,28,19,73.1,26,7,97,3,32,32,2,20,64,10,25
5c899683,Felix Passlack,25,Bochum,Bundesliga,10.7,1998,DF,11,2,13,14,58.3,24,10,21,0,10,21,2,9,31,10,14
5c954071,Mahmut Kucuksahin,19,Augsburg,Bundesliga,0.0,2004,MF,0,0,0,0,"",0,0,0,0,0,0,0,0,0,0,0
5c96b017,Ruben Garcia,30,Osasuna,La Liga,17.2,1993,"FW,MF",20,3,23,13,39.4,33,20,23,0,12,32,7,8,44,17,18
5ca20b7a,Joseba Zaldua,31,Cádiz,La Liga,7.8,1992,DF,2,4,6,13,61.9,21,8,20,0,2,20,1,17,22,2,12
5cbb5ad6,Filippo Terracciano,20,Milan,Serie A,0.8,2003,"DF,FW",3,0,3,1,33.3,3,2,1,0,0,2,0,1,2,1,2
5cbd1eb0,Tyrick Mitchell,23,Crystal Palace,Premier League,35.6,1999,"DF,MF",53,10,63,43,71.7,60,17,104,0,26,105,9,75,131,21,60
5ccc9672,Alejandro Balde,19,Barcelona,La Liga,15.3,2003,DF,13,1,14,7,63.6,11,4,21,1,5,20,3,11,25,6,11
5ce497e2,Yoram Zague,17,Paris S-G,Ligue 1,4.1,2006,DF,3,0,3,11,45.8,24,13,9,1,4,18,3,11,22,4,8
5cfc74fc,Gaetano Oristanio,20,Cagliari,Serie A,12.3,2002,"FW,MF",11,0,11,5,29.4,17,12,8,0,9,20,1,5,29,14,10
5cfec13d,Carl Starfelt,28,Celta Vigo,La Liga,24.6,1995,DF,7,28,35,19,67.9,28,9,159,2,34,36,1,30,70,5,30
5d004b30,Yanis Issoufou,16,Montpellier,Ligue 1,0.1,2006,MF,0,0,0,0,"",0,0,0,0,0,0,0,0,0,0,0
5d0e0a1f,Adrien Truffert,21,Rennes,Ligue 1,23.8,2001,DF,26,5,31,25,62.5,40,15,49,0,19,39,6,23,58,10,21
5d36f616,Christ Mbondi,18,Reims,Ligue 1,0.0,2004,FW,0,0,0,1,100.0,1,0,0,0,0,1,0,1,1,0,1
5d4f7d61,Patrik Schick,27,Leverkusen,Bundesliga,11.8,1996,FW,2,0,2,1,20.0,5,4,7,0,1,6,3,0,7,3,4
5d68f5b2,Lucas,22,Cádiz,La Liga,17.1,2001,DF,23,4,27,32,58.2,55,23,45,0,17,47,4,32,64,11,27
5d8d7454,Frederic Guilbert,28,Strasbourg,Ligue 1,27.7,1994,"DF,MF",29,10,39,47,65.3,72,25,99,1,71,87,8,49,158,30,50
5d8e331f,Nicolas Hofler,33,Freiburg,Bundesliga,25.9,1990,MF,14,16,30,22,44.9,49,27,45,0,31,63,7,36,94,20,40
5db04597,Pablo Maffeo,26,Mallorca,La Liga,16.2,1997,DF,10,2,12,23,57.5,40,17,23,0,10,35,4,18,45,13,22
5db45ee5,Maximilian Beier,20,Hoffenheim,Bundesliga,26.9,2002,"FW,MF",20,1,21,4,21.1,19,15,12,0,9,20,4,5,29,11,12
5dbefa9d,Andre Ayew,33,Le Havre,Ligue 1,12.3,1989,FW,5,3,8,6,66.7,9,3,11,0,2,15,2,7,17,6,11
5dbfd101,Noah Loosli,26,Bochum,Bundesliga,3.8,1997,DF,6,1,7,7,50.0,14,7,18,0,7,10,0,6,17,4,7
5dc15574,Milos Pantovic,27,Union Berlin,Bundesliga,0.2,1996,MF,0,0,0,0,"",0,0,0,0,0,0,0,0,0,0,0
5ddb8f9f,Danny da Costa,30,Mainz 05,Bundesliga,9.2,1993,DF,13,4,17,9,47.4,19,10,24,0,16,18,2,9,34,7,9
5dde403b,Karlo Lulic,27,Frosinone,Serie A,0.2,1996,MF,1,0,1,0,"",0,0,0,0,1,0,0,0,1,0,0
5de3866c,Patrick Ciurria,28,Monza,Serie A,17.8,1995,"DF,MF",15,5,20,13,61.9,21,8,28,0,9,30,4,13,39,13,18
5dfc6ad5,Axel Witsel,34,Atlético Madrid,La Liga,30.9,1989,DF,19,21,40,17,70.8,24,7,119,0,16,35,0,23,51,12,21
5e080f73,Irvin Cardona,25,Augsburg,Bundesliga,0.6,1997,"MF,DF",1,0,1,1,33.3,3,2,1,0,0,1,1,0,1,0,1
5e1028e5,Franco Cervi,29,Celta Vigo,La Liga,6.1,1994,"MF,DF",16,0,16,13,54.2,24,11,4,0,9,24,2,13,33,9,18
5e22e2a4,Baptiste Santamaria,28,Rennes,Ligue 1,21.4,1995,MF,9,6,15,29,63.0,46,17,33,1,34,52,6,21,86,25,33
5e3ecc35,Pietro Comuzzo,18,Fiorentina,Serie A,0.5,2005,"DF,FW",1,0,1,1,100.0,1,0,2,0,1,1,0,1,2,0,1
5e4d9b48,Jamie Donley,18,Tottenham,Premier League,0.0,2005,FW,0,0,0,0,"",0,0,3,0,0,0,0,0,0,0,0
5e6355f8,Yanis Begraoui,22,Toulouse,Ligue 1,3.3,2001,"FW,MF",4,0,4,3,33.3,9,6,5,0,5,5,1,1,10,3,3
5e66fa06,Waldemar Anton,27,Stuttgart,Bundesliga,32.1,1996,DF,13,20,33,23,54.8,42,19,150,1,40,39,2,21,79,16,25
5e861944,Matteo Politano,29,Napoli,Serie A,26.2,1993,FW,8,1,9,11,32.4,34,23,11,1,15,19,4,8,34,7,8
5ea8ef20,Matteo Guendouzi,24,Marseille,Ligue 1,0.2,1999,MF,0,1,1,0,"",0,0,0,0,0,0,0,0,0,0,0
5eae500a,Romelu Lukaku,30,Roma,Serie A,29.3,1993,FW,6,1,7,2,50.0,4,2,19,1,0,6,3,1,6,2,5
5eaed77a,Johan Vasquez,24,Genoa,Serie A,31.7,1998,DF,24,26,50,32,64.0,50,18,113,0,45,51,2,38,96,11,33
5ed97752,Iliman Ndiaye,23,Marseille,Ligue 1,18.0,2000,"FW,MF",12,2,14,11,37.9,29,18,6,0,6,21,5,5,27,11,18
5ed9b537,Ibrahima Konate,24,Liverpool,Premier League,17.5,1999,DF,6,12,18,18,75.0,24,6,51,1,20,36,1,22,56,13,22
5eecec3d,John Stones,29,Manchester City,Premier League,11.8,1994,"DF,MF",4,7,11,0,0.0,3,3,21,0,10,2,1,1,12,0,1
5efc5389,Charalambos Lykogiannis,29,Bologna,Serie A,10.0,1993,DF,10,5,15,5,50.0,10,5,30,0,5,10,1,5,15,4,6
5f346071,Andre Brooks,19,Sheffield Utd,Premier League,10.4,2003,"MF,DF",12,1,13,9,42.9,21,12,20,0,14,22,4,7,36,11,13
5f3eaaf5,Moses Simon,28,Nantes,Ligue 1,19.9,1995,"FW,MF",8,1,9,2,25.0,8,6,5,1,3,7,0,2,10,5,5
5fa57166,Matteo Lovato,23,Salernitana,Serie A,10.5,2000,DF,7,7,14,16,66.7,24,8,41,1,18,27,2,17,45,8,14
5fa714d5,Alex Sola,24,Real Sociedad,La Liga,0.3,1999,"DF,MF",0,0,0,0,"",0,0,2,0,1,0,0,0,1,0,0
5fd5e542,Mateu Morey,23,Dortmund,Bundesliga,1.2,2000,DF,2,1,3,2,50.0,4,2,3,0,1,2,0,1,3,1,2
5fd5ed86,Gleison Bremer,26,Juventus,Serie A,35.9,1997,DF,18,27,45,21,72.4,29,8,147,0,40,58,5,32,98,21,42
5fdcb075,Thibault De Smet,25,Reims,Ligue 1,20.3,1998,DF,20,5,25,33,55.9,59,26,51,1,21,56,4,36,77,16,35
5ff4ab71,Enzo Fernandez,22,Chelsea,Premier League,24.5,2001,MF,23,13,36,27,41.5,65,38,28,0,17,50,10,22,67,18,22
6025fab1,Luka Modric,37,Real Madrid,La Liga,18.8,1985,MF,9,4,13,9,36.0,25,16,9,0,21,22,6,10,43,6,15
60344e4f,Josh Dasilva,24,Brentford,Premier League,0.3,1998,"DF,FW",0,0,0,0,"",0,0,0,0,0,2,1,0,2,1,1
603cb947,Andrej Kramaric,32,Hoffenheim,Bundesliga,24.4,1991,"MF,FW",12,2,14,6,46.2,13,7,12,2,10,11,2,5,21,4,2
6043997c,Gerzino Nyamsi,26,Strasbourg,Ligue 1,12.1,1997,DF,8,11,19,12,66.7,18,6,43,0,10,18,0,13,28,5,14
608f2092,Johan Mojica,30,Osasuna,La Liga,22.7,1992,DF,13,2,15,16,64.0,25,9,40,2,21,30,4,11,51,15,22
610aa1e9,Luca Kilian,23,Köln,Bundesliga,7.1,1999,DF,7,5,12,9,64.3,14,5,28,0,7,16,0,15,23,1,9
61220da2,Jose Campana,30,Las Palmas,La Liga,1.9,1993,MF,1,2,3,0,0.0,2,2,3,0,2,2,0,1,4,1,2
61590953,"Stanley N'Soki",24,Hoffenheim,Bundesliga,7.0,1999,DF,11,2,13,17,58.6,29,12,33,0,8,21,1,12,29,8,10
616c09f5,Adrian Beck,26,Heidenheim,Bundesliga,10.8,1997,"MF,FW",17,0,17,9,37.5,24,15,15,0,4,22,2,8,26,12,13
6190474d,Jeong Woo-yeong,23,Stuttgart,Bundesliga,7.0,1999,"MF,FW",5,0,5,6,75.0,8,2,5,0,7,15,1,6,22,8,9
6191093d,Ludovic Blas,25,Rennes,Ligue 1,17.4,1997,"FW,MF",12,1,13,12,42.9,28,16,9,0,6,30,1,16,36,13,14
61b3978f,Bartosz Bereszynski,31,Empoli,Serie A,19.6,1992,DF,12,10,22,24,60.0,40,16,52,0,21,41,3,25,62,13,25
61efb926,Alberto Dossena,24,Cagliari,Serie A,33.1,1998,DF,23,27,50,32,66.7,48,16,172,2,45,55,0,43,100,12,35
61f80c89,Mamadou Sarr,17,Lyon,Ligue 1,0.1,2005,DF,0,0,0,0,"",0,0,0,0,0,0,0,0,0,0,0
620922ed,Radu Dragu?in,21,Genoa,Serie A,19.0,2002,DF,6,12,18,8,88.9,9,1,87,3,21,16,1,9,37,6,11
6250083a,Oliver Skipp,22,Tottenham,Premier League,7.9,2000,"MF,DF",11,1,12,11,61.1,18,7,9,0,3,18,3,9,21,6,12
6265208f,Joselu,33,Real Madrid,La Liga,18.7,1990,FW,10,1,11,0,0.0,7,7,11,0,6,6,1,1,12,4,3
627c7a3d,Rabby Nzingoula,17,Strasbourg,Ligue 1,1.5,2005,"MF,FW",4,0,4,3,75.0,4,1,0,0,5,3,0,0,8,3,3
62ab9184,Yannick Gerhardt,29,Wolfsburg,Bundesliga,18.1,1994,"MF,DF",13,2,15,9,28.1,32,23,35,0,7,31,3,16,38,12,20
636eae97,Toni Villa,28,Girona,La Liga,0.1,1995,FW,0,0,0,0,"",0,0,0,0,0,0,0,0,0,0,0
63787ec5,Inaki Gonzalez,19,Las Palmas,La Liga,0.1,2004,MF,0,0,0,0,"",0,0,1,0,0,1,0,1,1,0,0
6388e356,Falaye Sacko,28,Montpellier,Ligue 1,15.4,1995,DF,12,7,19,21,65.6,32,11,37,0,24,28,5,13,52,10,16
638a4d71,Marvin Ducksch,29,Werder Bremen,Bundesliga,30.0,1994,FW,2,0,2,6,42.9,14,8,25,0,4,8,1,4,12,3,3
63b0ca6b,Alvaro Negredo,37,Cádiz,La Liga,0.6,1985,"FW,MF",1,0,1,0,"",0,0,0,0,1,0,0,0,1,0,0
63b9cc6d,Masaya Okugawa,27,Augsburg,Bundesliga,0.4,1996,"FW,DF",0,0,0,0,"",0,0,2,0,0,0,0,0,0,0,0
63c5e56b,Pep Chavarria,25,Rayo Vallecano,La Liga,13.0,1998,"DF,MF",12,3,15,11,64.7,17,6,29,1,6,23,2,15,29,6,18
63f04c6c,Alfonso Pedraza,27,Villarreal,La Liga,12.4,1996,DF,9,7,16,9,52.9,17,8,19,0,13,25,2,18,38,5,9
640134d6,Damion Downs,19,Köln,Bundesliga,2.0,2004,"FW,MF",1,0,1,1,50.0,2,1,1,0,0,1,0,1,1,0,1
6411925d,Seydou Fini,17,Genoa,Serie A,0.4,2006,"DF,FW",0,0,0,0,"",0,0,0,0,0,0,0,0,0,0,0
6412cc03,Fabio Vieira,23,Arsenal,Premier League,3.3,2000,"MF,FW",0,0,0,3,100.0,3,0,2,0,2,3,1,2,5,0,2
6416adf0,Triantafyllos Pasaridis,27,Salernitana,Serie A,5.0,1996,DF,4,3,7,9,64.3,14,5,19,0,3,11,0,9,14,2,7
6434f10d,Rodri,27,Manchester City,Premier League,32.6,1996,MF,24,8,32,29,48.3,60,31,41,4,26,70,12,25,96,33,43
645a3363,Angel Gomes,22,Lille,Ligue 1,28.6,2000,MF,17,6,23,14,43.8,32,18,28,1,18,26,7,4,44,15,13
645dffbf,Saba Sazonov,21,Torino,Serie A,4.0,2002,DF,3,5,8,3,100.0,3,0,22,0,3,9,0,4,12,5,7
6499048c,Andrea Colpani,24,Monza,Serie A,29.5,1999,"MF,FW",7,4,11,11,55.0,20,9,14,0,14,25,6,6,39,13,15
649b57e9,Jhoanner Chavez,21,Lens,Ligue 1,5.3,2002,DF,2,0,2,3,33.3,9,6,11,0,5,6,2,2,11,2,5
64ba07c0,Ronael Pierre-Gabriel,25,Nantes,Ligue 1,6.6,1998,DF,9,4,13,5,71.4,7,2,25,0,8,15,1,12,23,2,9
64c14d49,Dion Lopy,21,Almería,La Liga,21.3,2002,MF,18,5,23,17,38.6,44,27,22,2,15,62,6,36,77,20,37
64cd167d,Davide Biraschi,29,Genoa,Serie A,1.0,1994,DF,0,0,0,1,33.3,3,2,5,0,2,3,0,1,5,2,3
64d7f629,Rasmus Carstensen,22,Köln,Bundesliga,18.4,2000,"DF,FW",29,9,38,31,55.4,56,25,50,2,20,47,4,23,67,20,22
64e8ed6d,Borja Mayoral,26,Getafe,La Liga,23.9,1997,FW,7,0,7,5,22.7,22,17,16,0,4,9,5,2,13,2,5
64f69877,Kevin Volland,31,Union Berlin,Bundesliga,14.9,1992,"FW,MF",8,0,8,8,40.0,20,12,12,0,6,22,6,8,28,8,9
6510ee8d,Marko Mladenovic,18,Eint Frankfurt,Bundesliga,0.1,2005,MF,0,0,0,0,"",0,0,0,0,0,0,0,0,0,0,0
65154df0,Rodrigo Riquelme,23,Atlético Madrid,La Liga,17.0,2000,"DF,MF",19,0,19,18,39.1,46,28,20,0,9,30,8,18,39,4,19
652d4c37,Corentin Tolisso,28,Lyon,Ligue 1,19.3,1994,MF,17,9,26,14,42.4,33,19,18,0,10,33,9,13,43,11,21
65857fdf,Tim Skarke,26,Darmstadt 98,Bundesliga,26.7,1996,"FW,DF",23,2,25,10,35.7,28,18,20,0,6,26,4,12,32,10,16
65c3efa2,Odeluga Offiah,20,Brighton,Premier League,1.4,2002,DF,0,0,0,1,100.0,1,0,0,0,1,1,0,1,2,0,0
65c55288,Youssouf Ndayishimiye,24,Nice,Ligue 1,19.0,1998,"MF,DF",8,11,19,12,52.2,23,11,47,1,12,31,2,17,43,12,20
65fd099c,Abdou Harroui,25,Frosinone,Serie A,11.3,1998,"MF,FW",16,3,19,8,50.0,16,8,8,0,5,23,1,11,28,11,11
66017b9d,Bruno Mendez,23,Granada,La Liga,14.8,1999,DF,18,6,24,21,56.8,37,16,45,0,26,36,5,19,62,12,17
66116290,Radamel Falcao,37,Rayo Vallecano,La Liga,4.5,1986,"FW,DF",2,0,2,1,33.3,3,2,4,0,3,7,1,1,10,5,5
6613c819,Tomas Soucek,28,West Ham,Premier League,31.9,1995,MF,27,28,55,21,44.7,47,26,109,0,37,53,3,24,90,26,35
6620c21a,Kassoum Ouattara,18,Monaco,Ligue 1,7.1,2004,"DF,FW",11,0,11,9,45.0,20,11,20,0,13,17,4,8,30,5,12
6639e500,Andreas Pereira,27,Fulham,Premier League,29.0,1996,MF,14,2,16,11,26.8,41,30,12,0,4,25,9,4,29,12,12
66654daa,Nahuel Tenaglia,27,Alavés,La Liga,12.7,1996,DF,6,8,14,16,57.1,28,12,59,0,12,29,3,22,41,4,19
6763373d,Miguel,23,Alavés,La Liga,0.7,1999,"FW,MF",2,0,2,0,"",0,0,0,0,0,0,0,0,0,0,0
6763f716,Leny Yoro,17,Lille,Ligue 1,29.7,2005,DF,6,14,20,17,54.8,31,14,97,1,36,36,2,27,72,7,25
677da306,Ohis Felix Uduokhai,25,Augsburg,Bundesliga,32.5,1997,DF,10,35,45,16,64.0,25,9,178,2,46,37,5,18,83,14,21
67ac5bb8,Gabriel Magalhaes,25,Arsenal,Premier League,33.8,1997,DF,11,33,44,17,77.3,22,5,100,1,31,48,2,24,79,22,28
6841f107,Alessandro Vogliacco,24,Genoa,Serie A,13.0,1998,DF,6,10,16,12,80.0,15,3,40,1,30,23,1,14,53,8,15
686cbe7d,Umar Sadiq,26,Real Sociedad,La Liga,12.0,1997,FW,9,0,9,4,50.0,8,4,10,0,0,15,5,2,15,8,10
68a26d51,Pedro Chirivella,26,Nantes,Ligue 1,28.8,1997,MF,17,5,22,30,39.5,76,46,28,0,31,50,1,20,81,29,28
68b7e72e,Anthony Oyono,22,Frosinone,Serie A,13.3,2001,DF,14,3,17,23,67.6,34,11,32,0,9,37,2,21,46,14,26
691bef82,Daley Blind,33,Girona,La Liga,33.0,1990,DF,18,19,37,29,61.7,47,18,113,0,21,47,1,33,68,13,21
6928979a,Nicolo Barella,26,Inter,Serie A,31.6,1997,MF,30,1,31,19,30.2,63,44,12,1,10,46,9,17,56,20,30
697dc00a,Bartol Franjic,23,Darmstadt 98,Bundesliga,13.7,2000,MF,8,4,12,7,25.0,28,21,29,2,30,15,1,4,45,10,12
698f11e3,Moussa Diarra,22,Toulouse,Ligue 1,15.5,2000,DF,16,14,30,13,48.1,27,14,43,0,20,32,1,16,52,15,12
6993927b,Florent Ogier,34,Clermont Foot,Ligue 1,10.5,1989,DF,6,19,25,11,61.1,18,7,35,3,9,19,0,13,28,6,9
69942fb3,James Hill,21,Bournemouth,Premier League,0.8,2002,DF,1,2,3,1,100.0,1,0,8,0,3,3,0,1,6,2,2
699fb8db,Dominique Heintz,29,Köln,Bundesliga,6.3,1993,DF,5,1,6,8,66.7,12,4,28,0,3,12,0,6,15,6,5
69c9532c,Adel Mahamoud,20,Nantes,Ligue 1,0.1,2003,FW,0,0,0,0,0.0,1,1,0,0,0,0,0,0,0,0,0
69e930e4,Mamady Bangre,22,Toulouse,Ligue 1,1.1,2001,"FW,MF",0,0,0,3,75.0,4,1,3,0,4,4,0,2,8,2,2
6a7353d7,Willy Kambwala,18,Manchester Utd,Premier League,3.7,2004,DF,3,3,6,1,33.3,3,2,14,1,4,3,0,1,7,2,1
6a827d8e,Youcef Atal,27,Nice,Ligue 1,4.0,1996,DF,6,1,7,6,75.0,8,2,1,0,4,9,1,6,13,2,3
6a8a7af8,Vinicius Souza,24,Sheffield Utd,Premier League,29.6,1999,MF,40,17,57,41,55.4,74,33,75,1,32,125,15,59,157,51,76
6a99e0b1,Inaki Williams,29,Athletic Club,La Liga,31.6,1994,FW,34,8,42,13,38.2,34,21,29,0,14,24,10,6,38,8,17
6af30900,Tyronne Ebuehi,27,Empoli,Serie A,12.2,1995,DF,5,4,9,7,63.6,11,4,27,1,6,14,0,9,20,5,9
6afaebf2,Bryan Mbeumo,23,Brentford,Premier League,21.8,1999,FW,24,2,26,5,26.3,19,14,13,0,7,15,3,6,22,6,10
6b21b7b5,Reinier,21,Frosinone,Serie A,11.8,2002,"MF,FW",20,4,24,5,29.4,17,12,5,0,10,21,3,6,31,12,10
6b587d3d,Hamza Rafia,24,Lecce,Serie A,13.4,1999,MF,26,1,27,13,43.3,30,17,13,0,11,44,4,13,55,27,31
6b5ea2f4,Gorka Guruzeta,26,Athletic Club,La Liga,24.6,1996,FW,34,2,36,9,30.0,30,21,23,0,17,34,3,6,51,25,23
6b5edd5d,Valentin Atangana Edoa,17,Reims,Ligue 1,6.2,2005,MF,4,1,5,5,38.5,13,8,9,0,6,19,4,6,25,9,13
6b635f5c,Ardian Ismajli,26,Empoli,Serie A,22.7,1996,DF,11,17,28,18,78.3,23,5,126,1,23,26,2,18,49,6,16
6b8887c2,Steffen Tigges,25,Köln,Bundesliga,8.1,1998,FW,2,2,4,3,42.9,7,4,12,0,1,10,1,4,11,5,6
6b9960cf,Warren Zaire-Emery,17,Paris S-G,Ligue 1,21.8,2006,"MF,DF",24,8,32,28,54.9,51,23,22,2,15,51,9,18,66,24,28
6bb2c084,Andre-Frank Zambo Anguissa,27,Napoli,Serie A,31.0,1995,MF,35,5,40,34,49.3,69,35,19,1,28,61,11,21,89,29,33
6bca20fe,Enzo Loiodice,22,Las Palmas,La Liga,19.9,2000,MF,18,2,20,20,47.6,42,22,16,1,12,62,13,15,74,34,35
6bd5cd5d,Robin Knoche,31,Union Berlin,Bundesliga,21.3,1992,DF,8,19,27,19,63.3,30,11,73,0,13,34,0,27,47,7,22
6bde367b,Teji Savanier,31,Montpellier,Ligue 1,30.7,1991,MF,28,8,36,14,22.2,63,49,28,1,33,37,6,16,70,15,20
6be41a31,Yann Gboho,22,Toulouse,Ligue 1,13.3,2001,"MF,FW",20,1,21,8,34.8,23,15,2,0,4,14,2,6,18,6,4
6c203af0,Yves Bissouma,26,Tottenham,Premier League,23.0,1996,MF,23,5,28,41,67.2,61,20,43,3,37,80,12,32,117,36,52
6c7762c3,Juan Foyth,25,Villarreal,La Liga,11.8,1998,DF,13,4,17,12,44.4,27,15,44,0,12,26,0,18,38,8,15
6c811eb7,Carles Alena,25,Getafe,La Liga,11.3,1998,MF,11,3,14,10,41.7,24,14,13,0,4,24,3,7,28,14,8
6c8ddd52,Sacha Boey,22,Bayern Munich,Bundesliga,1.2,2000,DF,1,0,1,1,50.0,2,1,2,0,1,2,0,2,3,0,0
6c9642ae,Nolan Mbemba,28,Le Havre,Ligue 1,0.2,1995,MF,0,0,0,1,50.0,2,1,0,0,0,2,1,0,2,1,1
6ca5ec4b,Alex Iwobi,27,Fulham,Premier League,24.4,1996,"FW,MF",16,0,16,12,48.0,25,13,9,0,14,29,2,12,43,15,18
6caffe81,Enzo Barrenechea,22,Frosinone,Serie A,31.2,2001,MF,35,12,47,28,40.0,70,42,61,2,27,65,8,28,92,29,42
6cc97b6a,Alberto Grassi,28,Empoli,Serie A,20.1,1995,MF,15,11,26,10,38.5,26,16,37,0,41,30,4,13,71,13,18
6ce1f46f,Toni Kroos,33,Real Madrid,La Liga,23.6,1990,MF,18,4,22,24,40.7,59,35,11,1,17,53,9,19,70,25,34
6ce2cdf0,Cheick Konate,19,Clermont Foot,Ligue 1,11.9,2004,DF,14,2,16,20,55.6,36,16,21,0,13,26,0,17,39,9,15
6ce43701,Youssoufa Moukoko,18,Dortmund,Bundesliga,6.9,2004,FW,3,1,4,3,42.9,7,4,4,0,2,4,0,2,6,2,1
6d0fe035,Habib Diarra,19,Strasbourg,Ligue 1,25.6,2004,"MF,FW",19,4,23,9,27.3,33,24,15,0,17,30,2,8,47,20,23
6d2b0ada,Malick Mbaye,19,Metz,Ligue 1,1.7,2004,"MF,FW",1,0,1,1,50.0,2,1,2,0,1,5,4,0,6,1,1
6d5701f2,Yerry Mina,28,Cagliari,Serie A,13.5,1994,DF,9,14,23,13,68.4,19,6,77,0,4,20,0,14,24,6,13
6de23ab0,Sinaly Diomande,22,Lyon,Ligue 1,9.9,2001,DF,3,9,12,9,56.3,16,7,26,1,15,10,2,5,25,3,4
6dfd8f05,Romain Perraud,25,Nice,Ligue 1,4.1,1997,"DF,FW",4,0,4,4,36.4,11,7,15,1,6,7,1,5,13,1,6
6e058f06,Giacomo Raspadori,23,Napoli,Serie A,17.6,2000,"FW,MF",14,1,15,6,40.0,15,9,7,0,3,21,5,6,24,10,10
6e269dd3,Mikkel Kaufmann,22,Union Berlin,Bundesliga,5.4,2001,FW,12,0,12,3,30.0,10,7,4,0,1,6,1,2,7,3,3
6e33125f,Kevin Danso,24,Lens,Ligue 1,29.5,1998,DF,13,30,43,15,50.0,30,15,115,1,23,24,1,12,47,11,14
6e4df551,Papu Gomez,35,Monza,Serie A,0.5,1988,"MF,FW",0,0,0,0,0.0,2,2,0,0,1,0,0,0,1,0,0
6e7f1353,Morgan Sanson,28,Nice,Ligue 1,21.8,1994,MF,29,5,34,12,38.7,31,19,16,0,20,26,7,12,46,7,19
6eaed4eb,Florian Lejeune,32,Rayo Vallecano,La Liga,37.0,1991,DF,15,18,33,19,63.3,30,11,155,1,23,39,2,26,62,11,25
6ec6fde0,Kevin Akpoguma,28,Hoffenheim,Bundesliga,12.2,1995,DF,20,8,28,26,74.3,35,9,32,0,18,35,1,22,53,12,18
6ecbddf6,Ruben Vargas,24,Augsburg,Bundesliga,21.8,1998,"MF,FW",15,4,19,10,40.0,25,15,17,0,7,23,7,6,30,10,10
6eee05f1,Berat Djimsiti,30,Atalanta,Serie A,31.5,1993,DF,20,33,53,19,61.3,31,12,100,0,57,42,1,29,99,12,24
6f392eb8,Hugo Alvarez,20,Celta Vigo,La Liga,8.5,2003,"MF,DF",3,1,4,9,45.0,20,11,9,0,5,14,3,8,19,3,9
6f4c734d,Jose Mari,35,Cádiz,La Liga,0.2,1987,"MF,FW",0,0,0,1,50.0,2,1,0,0,0,2,0,0,2,2,1
6f5ec8bb,Facundo Medina,24,Lens,Ligue 1,30.2,1999,DF,25,13,38,44,63.8,69,25,59,2,24,64,8,25,88,31,38
6f5f82c0,Andoni Gorosabel,26,Alavés,La Liga,31.7,1996,DF,16,8,24,38,50.7,75,37,69,0,28,62,5,40,90,17,42
6f7d826d,Douglas Luiz,25,Aston Villa,Premier League,33.3,1998,MF,24,8,32,25,47.2,53,28,18,2,23,58,10,21,81,27,38
6f806d99,Enzo Le Fee,23,Rennes,Ligue 1,17.0,2000,MF,14,3,17,23,48.9,47,24,20,0,19,50,10,23,69,17,35
6f8cd6d0,Marcus Thuram,25,Inter,Serie A,29.9,1997,FW,23,3,26,4,30.8,13,9,19,0,4,23,5,9,27,9,15
6fd76804,Ayanda Sishuba,18,Lens,Ligue 1,0.7,2005,"MF,FW",1,0,1,1,50.0,2,1,0,0,0,3,1,0,3,2,1
6fdac234,Jaka Bijol,24,Udinese,Serie A,23.2,1999,DF,15,21,36,22,62.9,35,13,140,1,23,43,0,34,66,9,27
6fe90922,Ivan Perisic,34,Tottenham,Premier League,1.1,1989,FW,1,0,1,3,60.0,5,2,1,0,2,3,1,1,5,1,2
70006831,Giorgi Kvernadze,20,Frosinone,Serie A,0.7,2003,"FW,DF",1,0,1,2,100.0,2,0,0,0,1,3,1,2,4,0,0
700783e7,Levi Colwill,20,Chelsea,Premier League,20.0,2003,DF,18,10,28,26,76.5,34,8,66,0,26,48,5,26,74,17,30
7016332f,Ricardo Visus,22,Betis,La Liga,1.8,2001,DF,0,2,2,2,100.0,2,0,9,1,2,2,0,1,4,1,2
705a1642,Reda Belahyane,19,Nice,Ligue 1,0.3,2004,MF,0,0,0,1,100.0,1,0,0,0,0,1,0,0,1,1,0
707b98f1,Valentin Carboni,18,Monza,Serie A,13.0,2005,"MF,FW",11,1,12,8,30.8,26,18,4,0,7,25,3,10,32,12,15
70c52749,Birger Meling,28,Rennes,Ligue 1,0.2,1994,DF,1,0,1,1,100.0,1,0,0,0,0,1,0,1,1,0,1
70d4c949,Jean Matteo Bahoya,18,Eint Frankfurt,Bundesliga,2.0,2005,"MF,FW",2,0,2,1,25.0,4,3,1,0,1,3,0,0,4,3,1
70dcf94d,Janik Haberer,29,Union Berlin,Bundesliga,13.6,1994,"MF,DF",17,4,21,22,48.9,45,23,18,0,12,36,7,16,48,13,24
70f8e0bd,Dani Rodriguez,35,Mallorca,La Liga,29.1,1988,MF,29,5,34,21,46.7,45,24,21,0,15,47,6,21,62,20,24
710045fb,Max Moerstedt,"",Hoffenheim,Bundesliga,0.1,,"DF,FW",0,0,0,0,0.0,1,1,0,0,0,0,0,0,0,0,0
7111d552,Vinicius Junior,23,Real Madrid,La Liga,20.7,2000,FW,13,0,13,3,25.0,12,9,3,2,1,18,8,5,19,5,13
7155e3e1,Pape Gueye,24,Marseille,Ligue 1,8.5,1999,"MF,DF",14,3,17,13,68.4,19,6,12,0,13,33,3,11,46,19,21
71ec39ef,Lucas Tousart,26,Union Berlin,Bundesliga,17.5,1997,MF,23,9,32,17,45.9,37,20,41,0,25,35,4,14,60,17,20
71ef519e,Matt Ritchie,33,Newcastle Utd,Premier League,1.4,1989,"FW,MF",1,2,3,2,50.0,4,2,5,0,1,5,1,2,6,2,3
722494dc,Arthur Vermeeren,18,Atlético Madrid,La Liga,1.8,2005,MF,5,0,5,0,0.0,1,1,2,0,6,1,0,0,7,1,0
7226539b,Fran Garcia,23,Real Madrid,La Liga,15.5,1999,DF,13,3,16,13,41.9,31,18,28,1,19,25,2,11,44,12,17
72947847,Bruno Langa,25,Almería,La Liga,9.1,1997,DF,7,4,11,6,42.9,14,8,33,2,4,17,2,10,21,5,12
72a84002,Fali,29,Cádiz,La Liga,28.3,1993,DF,14,24,38,21,58.3,36,15,120,0,27,41,1,29,68,11,26
72c812f3,Idrissa Gana Gueye,33,Everton,Premier League,20.9,1989,MF,17,7,24,29,63.0,46,17,16,0,28,73,14,32,101,27,44
72f5b81f,Juan Cruz,24,Hellas Verona,Serie A,1.2,1999,"FW,MF",1,0,1,0,"",0,0,0,0,1,2,2,0,3,0,2
72f87f25,Cristian Volpato,19,Sassuolo,Serie A,7.2,2003,"MF,FW",7,0,7,9,36.0,25,16,5,0,1,16,1,9,17,6,8
73000a79,Daley Sinkgraven,28,Las Palmas,La Liga,4.3,1995,DF,2,3,5,2,25.0,8,6,9,0,6,11,0,6,17,5,5
7304f3b1,Karamoko Dembele,20,Brest,Ligue 1,0.2,2003,"MF,FW",0,0,0,0,"",0,0,0,0,0,0,0,0,0,0,0
7310786d,Keyliane Abdallah,17,Marseille,Ligue 1,0.0,2006,FW,0,0,0,0,"",0,0,0,0,0,0,0,0,0,0,0
731f1f5a,Steve Ngoura,18,Le Havre,Ligue 1,2.5,2005,"FW,MF",0,0,0,1,25.0,4,3,3,0,0,2,0,1,2,1,1
73341ace,Bobby Clark,18,Liverpool,Premier League,1.0,2005,MF,4,2,6,1,20.0,5,4,1,0,1,2,0,1,3,1,1
733f1a7d,Ben Doak,17,Liverpool,Premier League,0.2,2005,FW,0,0,0,0,"",0,0,0,0,0,0,0,0,0,0,0
7362a6f2,Aliou Badara Balde,20,Nice,Ligue 1,0.8,2002,"FW,DF",1,1,2,1,100.0,1,0,0,0,3,4,1,0,7,3,1
736c14ec,Marcos Pena,18,Almería,La Liga,4.9,2005,MF,6,3,9,6,50.0,12,6,8,0,13,19,0,12,32,7,14
737945d9,Angelo Borges,18,Strasbourg,Ligue 1,12.2,2004,"FW,MF",18,0,18,11,35.5,31,20,2,0,9,24,8,9,33,7,11
7399c7a8,Jack Robinson,29,Sheffield Utd,Premier League,32.1,1993,DF,16,33,49,25,64.1,39,14,132,2,33,43,0,29,76,14,28
73b1d65b,Ryan John Giles,23,Luton Town,Premier League,5.6,2000,"DF,MF",2,0,2,2,28.6,7,5,22,0,4,8,1,4,12,3,6
7410d325,Bertug Yildirim,21,Rennes,Ligue 1,5.2,2002,FW,8,0,8,3,37.5,8,5,4,0,0,7,2,2,7,3,5
741418c3,Alexis Claude-Maurice,25,Nice,Ligue 1,5.6,1998,MF,3,1,4,1,20.0,5,4,7,0,5,12,3,3,17,6,5
7426f085,Johnny Cardoso,21,Betis,La Liga,14.8,2001,MF,15,5,20,22,66.7,33,11,31,0,32,48,5,19,80,24,29
745ca0a3,Romain Faivre,25,Lorient,Ligue 1,16.1,1998,"MF,FW",5,1,6,6,40.0,15,9,3,1,7,13,4,5,20,4,6
7460ca0d,Daniel Parejo,34,Villarreal,La Liga,28.7,1989,MF,16,9,25,20,43.5,46,26,29,3,21,43,6,16,64,21,30
74618572,Kaoru Mitoma,26,Brighton,Premier League,16.5,1997,FW,14,1,15,5,26.3,19,14,12,0,5,13,3,3,18,7,6
74b2cd7e,Angelo Ogbonna,35,West Ham,Premier League,7.1,1988,DF,3,10,13,6,85.7,7,1,29,0,3,11,0,9,14,2,5
74c2d562,Gonzalo Garcia,19,Real Madrid,La Liga,0.2,2004,"FW,MF",0,1,1,0,0.0,1,1,1,0,0,0,0,0,0,0,0
74d4cec6,Vitinha,23,Marseille,Ligue 1,10.3,2000,FW,9,2,11,3,25.0,12,9,8,0,5,14,6,3,19,5,8
74e12f1e,Jack Cork,34,Burnley,Premier League,0.3,1989,MF,0,0,0,1,33.3,3,2,1,0,1,2,0,0,3,2,0
74e90475,Sergi Cardona,24,Las Palmas,La Liga,31.3,1999,DF,38,7,45,55,57.3,96,41,102,0,46,90,9,52,136,29,55
74f2e748,Jeremie Frimpong,22,Leverkusen,Bundesliga,25.0,2000,DF,26,0,26,8,40.0,20,12,17,0,7,26,7,12,33,7,17
75374ee7,Jens Odgaard,24,Bologna,Serie A,4.8,1999,"FW,MF",9,0,9,1,33.3,3,2,3,0,1,4,2,1,5,1,4
75402e99,Lennard Maloney,23,Heidenheim,Bundesliga,25.4,1999,MF,24,9,33,25,42.4,59,34,88,0,25,43,5,14,68,24,26
75438a9a,Mattia Viti,21,Sassuolo,Serie A,10.9,2002,DF,10,10,20,10,45.5,22,12,44,0,10,24,3,14,34,7,15
755da865,Ruben Lendinez,20,Valencia,La Liga,0.1,2003,DF,0,0,0,1,100.0,1,0,1,0,0,2,0,0,2,2,2
75645f0e,Borja Iglesias,30,Leverkusen,Bundesliga,2.8,1993,FW,2,0,2,0,0.0,1,1,1,0,1,1,0,0,2,1,0
757a3431,Adria Altimira,22,Villarreal,La Liga,8.6,2001,"DF,MF",13,5,18,9,37.5,24,15,18,0,5,16,1,9,21,6,7
758dd7f0,Javier Manquillo,29,Celta Vigo,La Liga,8.3,1994,"DF,MF",11,3,14,8,53.3,15,7,17,0,3,15,4,6,18,5,11
75a66bed,Tadeo Allende,24,Celta Vigo,La Liga,3.7,1999,"MF,FW",3,0,3,4,66.7,6,2,3,0,3,6,1,3,9,2,1
75b86fb3,Alessandro Bastoni,24,Inter,Serie A,25.2,1999,DF,14,11,25,26,65.0,40,14,48,1,23,46,3,31,69,12,33
75bd6f48,Trivante Stewart,23,Salernitana,Serie A,1.1,2000,"FW,MF",1,0,1,0,"",0,0,0,0,0,0,0,0,0,0,0
75c62731,Mateusz Legowski,20,Salernitana,Serie A,12.7,2003,MF,11,2,13,11,42.3,26,15,16,0,7,23,3,8,30,12,12
75f1ed80,Emmanuel Agbadou,26,Reims,Ligue 1,28.8,1997,DF,22,25,47,44,68.8,64,20,116,1,55,65,4,38,120,23,41
75f2c59f,Roberto Pereyra,32,Udinese,Serie A,20.6,1991,"FW,MF",16,4,20,11,37.9,29,18,18,0,7,19,3,11,26,5,9
767d9605,Sydie Peck,18,Sheffield Utd,Premier League,0.1,2004,MF,0,0,0,0,"",0,0,0,0,0,0,0,0,0,0,0
76abb354,Hendry Blank,18,Dortmund,Bundesliga,0.5,2004,DF,1,0,1,1,100.0,1,0,4,0,0,1,0,1,1,0,0
76b2817e,Kingsley Ehizibue,28,Udinese,Serie A,10.6,1995,DF,18,3,21,11,61.1,18,7,36,0,8,22,2,16,30,4,14
76c2a023,Samu Costa,22,Mallorca,La Liga,25.6,2000,MF,14,14,28,46,49.5,93,47,59,3,39,91,5,40,130,46,50
76d679c7,Modibo Sagnan,24,Montpellier,Ligue 1,11.7,1999,DF,4,9,13,15,60.0,25,10,67,0,15,34,2,23,49,9,22
76fa965f,Philipp Forster,28,Bochum,Bundesliga,4.3,1995,"MF,FW",3,0,3,2,33.3,6,4,3,0,7,9,2,3,16,4,5
76ff8d0d,Kristian Thorstvedt,24,Sassuolo,Serie A,26.6,1999,MF,16,9,25,22,50.0,44,22,36,0,21,40,5,7,61,28,22
770d7eb8,Kenny Lala,31,Brest,Ligue 1,33.0,1991,DF,21,6,27,30,53.6,56,26,75,1,28,78,11,39,106,28,51
774cf58b,Max Aarons,23,Bournemouth,Premier League,13.7,2000,DF,4,5,9,20,58.8,34,14,27,0,8,29,2,20,37,7,19
77816c91,Benie Adama Traore,20,Nantes,Ligue 1,5.6,2002,"FW,MF",3,0,3,3,42.9,7,4,1,0,1,8,1,2,9,5,4
778ef829,Daniel Munoz,27,Crystal Palace,Premier League,16.0,1996,"DF,MF",22,7,29,19,50.0,38,19,47,0,24,55,10,31,79,14,35
779847d6,Nicolas Pallois,35,Nantes,Ligue 1,17.7,1987,DF,11,26,37,19,54.3,35,16,111,0,26,34,2,21,60,11,19
77cf6852,Emil Krafth,28,Newcastle Utd,Premier League,10.1,1994,DF,5,3,8,12,48.0,25,13,21,0,9,21,4,10,30,7,14
77cfae67,Clemens Riedel,20,Darmstadt 98,Bundesliga,8.4,2003,DF,8,3,11,15,62.5,24,9,26,0,11,22,1,16,33,5,13
77d7c96f,Kenny Tete,27,Fulham,Premier League,9.6,1995,DF,7,3,10,11,57.9,19,8,35,0,16,27,2,19,43,6,17
77e84962,Thiago Alcantara,32,Liverpool,Premier League,0.1,1991,MF,0,0,0,0,"",0,0,0,0,0,0,0,0,0,0,0
780e3631,Matteo Pessina,26,Monza,Serie A,35.8,1997,MF,18,11,29,23,46.9,49,26,46,1,27,44,4,20,71,20,25
78338347,Mirko Maric,28,Monza,Serie A,3.2,1995,FW,4,0,4,0,0.0,2,2,3,0,2,4,1,2,6,1,0
7868c973,Unai Ropero,21,Alavés,La Liga,0.1,2001,MF,0,0,0,0,"",0,0,0,0,0,0,0,0,0,0,0
78841da9,Jose Callejon,36,Granada,La Liga,8.9,1987,"MF,FW",6,1,7,8,36.4,22,14,10,0,5,13,0,10,18,3,6
788c0277,Chiedozie Ogbene,26,Luton Town,Premier League,22.2,1997,"MF,DF",11,3,14,12,54.5,22,10,34,2,7,17,0,10,24,7,10
78a3c38e,Pantelis Hatzidiakos,26,Cagliari,Serie A,9.5,1997,DF,9,5,14,10,58.8,17,7,30,1,13,22,0,12,35,10,10
78b8ac63,Oliver McBurnie,27,Sheffield Utd,Premier League,14.2,1996,FW,16,2,18,5,41.7,12,7,28,0,5,17,6,4,22,7,7
78f13530,Ola Solbakken,24,Roma,Serie A,0.3,1998,FW,0,0,0,0,"",0,0,0,0,0,0,0,0,0,0,0
79083382,Juan Jesus,32,Napoli,Serie A,23.5,1991,DF,11,12,23,23,69.7,33,10,67,1,23,42,2,28,65,12,19
7909ffa4,Joris Chotard,21,Montpellier,Ligue 1,28.7,2001,MF,26,21,47,48,50.0,96,48,60,0,44,81,11,45,125,25,52
79300479,Martin Odegaard,24,Arsenal,Premier League,34.3,1998,MF,22,1,23,17,29.3,58,41,5,0,15,49,10,18,64,21,17
794364d7,Berkan Kutlu,25,Genoa,Serie A,2.2,1998,MF,3,0,3,3,50.0,6,3,5,0,4,6,0,5,10,1,4
79443529,Dusan Vlahovic,23,Juventus,Serie A,25.6,2000,FW,2,2,4,4,36.4,11,7,11,0,1,9,3,0,10,6,5
7952d0c2,Jesper Karlsson,25,Bologna,Serie A,3.8,1998,FW,4,0,4,2,25.0,8,6,1,0,4,3,0,2,7,1,3
796a5f30,Jannik Muller,29,Darmstadt 98,Bundesliga,12.6,1994,"DF,MF",12,12,24,16,59.3,27,11,39,1,17,33,3,21,50,9,16
79b51257,Morgan Guilavogui,25,Lens,Ligue 1,6.3,1998,"FW,MF",9,2,11,5,45.5,11,6,7,0,4,21,5,4,25,12,10
79bc4c45,Ben Osborn,28,Sheffield Utd,Premier League,15.2,1994,"DF,MF",16,2,18,8,47.1,17,9,30,0,8,22,2,11,30,9,9
79c0821a,Mateo Kovacic,29,Manchester City,Premier League,17.2,1994,MF,22,1,23,18,64.3,28,10,10,0,10,36,5,16,46,15,25
79c84d1c,Jarrod Bowen,26,West Ham,Premier League,33.5,1996,FW,32,5,37,13,37.1,35,22,14,0,19,42,14,14,61,14,28
79c90e45,Pavel Kaderabek,31,Hoffenheim,Bundesliga,26.8,1992,"DF,FW",14,8,22,18,45.0,40,22,68,0,23,31,6,10,54,15,19
79ca3e23,Ondrej Duda,28,Hellas Verona,Serie A,27.3,1994,MF,17,12,29,31,59.6,52,21,21,0,26,59,7,17,85,35,39
79f7302a,Kilian Fischer,22,Wolfsburg,Bundesliga,3.2,2000,"DF,MF",7,1,8,2,40.0,5,3,12,0,1,8,1,4,9,3,6
7a11550b,Joe Gomez,26,Liverpool,Premier League,19.8,1997,DF,22,4,26,30,47.6,63,33,50,2,19,47,7,24,66,16,31
7a1f2c08,Jairo Riedewald,26,Crystal Palace,Premier League,2.6,1996,"MF,FW",0,0,0,3,50.0,6,3,2,0,2,9,3,2,11,4,3
7a42d0df,Florian Sotoca,32,Lens,Ligue 1,28.9,1990,"MF,FW",37,4,41,17,44.7,38,21,34,0,20,33,3,9,53,21,22
7aa8adfe,Alejandro Garnacho,19,Manchester Utd,Premier League,28.5,2004,FW,24,2,26,12,26.7,45,33,18,0,18,22,9,7,40,6,15
7af655fe,Francois Mughe,19,Marseille,Ligue 1,2.0,2004,"MF,DF",2,0,2,0,0.0,3,3,1,0,1,0,0,0,1,0,0
7af88b33,Max Lowe,26,Sheffield Utd,Premier League,5.6,1997,"DF,MF",6,4,10,8,53.3,15,7,15,0,5,21,3,13,26,5,10
7afb1573,Pepin,26,Monza,Serie A,2.7,1996,"MF,FW",3,2,5,2,50.0,4,2,6,0,0,6,1,1,6,4,1
7afbd2c3,Caleb Ekuban,29,Genoa,Serie A,12.6,1994,FW,8,3,11,5,55.6,9,4,7,0,1,8,2,2,9,4,4
7b082ec2,Maxime Busi,23,Reims,Ligue 1,1.8,1999,"FW,DF",5,1,6,0,0.0,2,2,5,0,4,2,1,0,6,1,0
7b355808,William Osula,19,Sheffield Utd,Premier League,8.7,2003,FW,2,1,3,1,50.0,2,1,9,0,2,2,1,1,4,0,2
7b5ab7f2,Bryan Gil,22,Tottenham,Premier League,2.3,2001,"FW,MF",3,0,3,1,25.0,4,3,4,0,3,1,1,0,4,0,0
7b9a9e25,Arnaud Nordin,25,Montpellier,Ligue 1,13.8,1998,"FW,MF",11,0,11,6,37.5,16,10,10,0,2,12,4,3,14,5,6
7b9c2d84,Eduardo Camavinga,20,Real Madrid,La Liga,20.2,2002,"MF,DF",28,8,36,23,59.0,39,16,29,1,29,76,8,39,105,29,47
7ba2eaa9,Pedro Neto,23,Wolves,Premier League,16.8,2000,"FW,MF",4,1,5,5,33.3,15,10,2,0,5,7,2,3,12,2,3
7bbb0ac4,Emir Karic,26,Darmstadt 98,Bundesliga,19.8,1997,DF,31,11,42,21,63.6,33,12,43,0,13,45,8,23,58,14,27
7bf9400b,Sepp van den Berg,21,Mainz 05,Bundesliga,31.5,2001,DF,30,36,66,15,57.7,26,11,159,2,43,38,3,20,81,15,23
7c104bb7,Ademola Lookman,25,Atalanta,Serie A,21.0,1997,"FW,MF",19,0,19,8,36.4,22,14,0,1,9,20,7,2,29,11,15
7c24eaf8,David Mamutovic,22,Mainz 05,Bundesliga,0.1,2000,"FW,DF",0,0,0,1,100.0,1,0,0,0,0,1,0,0,1,1,1
7c254c75,Samuele Di Benedetto,18,Stuttgart,Bundesliga,0.1,2005,MF,0,0,0,0,"",0,0,0,0,1,0,0,0,1,0,0
7c363088,Aimar Oroz,21,Osasuna,La Liga,26.0,2001,MF,25,2,27,13,35.1,37,24,11,0,16,43,5,18,59,20,26
7c3ed041,Leonardo Balerdi,24,Marseille,Ligue 1,25.2,1999,DF,23,15,38,49,73.1,67,18,91,0,51,79,1,55,130,23,50
7c4b4e36,Rare?-Catalin Burnete,19,Lecce,Serie A,0.1,2004,FW,0,0,0,0,"",0,0,0,0,0,0,0,0,0,0,0
7c56da38,Christopher Nkunku,25,Chelsea,Premier League,4.9,1997,"FW,MF",3,1,4,1,50.0,2,1,4,0,2,5,1,0,7,4,4
7c5fa6cf,Jordan Clark,29,Luton Town,Premier League,14.5,1993,MF,21,3,24,11,28.2,39,28,15,1,11,30,5,14,41,11,17
7c762839,Matteo Perez Vinlof,17,Bayern Munich,Bundesliga,0.2,2005,FW,0,0,0,0,"",0,0,0,0,1,0,0,0,1,0,0
7ca196eb,Nick Woltemade,21,Werder Bremen,Bundesliga,13.2,2002,"FW,MF",12,0,12,15,71.4,21,6,17,0,5,34,7,7,39,20,23
7cd520e8,Destiny Udogie,20,Tottenham,Premier League,26.6,2002,DF,19,8,27,27,55.1,49,22,80,5,37,68,11,41,105,16,33
7cdda3bf,Gaetan Laborde,29,Nice,Ligue 1,21.2,1994,"FW,MF",18,2,20,11,36.7,30,19,8,1,6,18,6,8,24,4,12
7d08063d,Tino Kadewere,27,Nantes,Ligue 1,8.7,1996,"FW,MF",9,1,10,6,54.5,11,5,8,0,10,9,3,3,19,3,4
7d31f1cb,Kenneth Schmidt,21,Freiburg,Bundesliga,0.8,2002,DF,1,0,1,2,50.0,4,2,2,0,1,2,0,2,3,0,2
7d42865e,Sam Curtis,17,Sheffield Utd,Premier League,0.3,2005,DF,2,0,2,1,50.0,2,1,0,0,0,1,0,1,1,0,0
7d450ed3,David Raum,25,RB Leipzig,Bundesliga,30.4,1998,DF,42,9,51,34,58.6,58,24,82,2,27,58,5,24,85,29,35
7d6d4395,Kevin Zeroli,18,Milan,Serie A,0.3,2005,MF,1,0,1,0,"",0,0,1,0,0,1,0,1,1,0,1
7d827b4f,Pablo Pagis,20,Lorient,Ligue 1,1.8,2002,MF,2,0,2,6,60.0,10,4,1,0,3,10,1,5,13,4,6
7d9397f8,Khephren Thuram,22,Nice,Ligue 1,23.4,2001,MF,11,10,21,20,50.0,40,20,37,0,18,42,6,13,60,23,29
7dcf86f6,Iago Aspas,35,Celta Vigo,La Liga,30.1,1987,FW,20,3,23,1,6.7,15,14,8,0,10,11,1,4,21,6,6
7e0b6c50,Davide Bartesaghi,17,Milan,Serie A,0.9,2005,"DF,MF",0,1,1,2,50.0,4,2,7,0,0,2,0,1,2,1,0
7e12a98d,Maxim Leitsch,25,Mainz 05,Bundesliga,4.2,1998,DF,2,0,2,3,50.0,6,3,13,0,4,6,0,5,10,1,3
7e5bebeb,Enso Gonzalez,18,Wolves,Premier League,0.0,2005,"MF,DF",0,0,0,0,0.0,1,1,0,0,0,0,0,0,0,0,0
7e82a78f,Florent Mollet,31,Nantes,Ligue 1,23.1,1991,"MF,FW",13,5,18,10,32.3,31,21,17,0,13,18,4,8,31,6,11
7e98cff1,Miguel Gutierrez,22,Girona,La Liga,33.7,2001,DF,16,11,27,13,37.1,35,22,66,2,22,29,4,11,51,14,18
7eb97a8e,Nicola Sansone,31,Lecce,Serie A,8.5,1991,"FW,MF",6,1,7,5,31.3,16,11,5,2,4,11,3,6,15,2,6
7ebd0896,Max Finkgrafe,19,Köln,Bundesliga,19.5,2004,"DF,FW",25,10,35,39,52.7,74,35,39,0,22,65,0,40,87,25,39
7ed08d5c,Josip Stanisic,23,Leverkusen,Bundesliga,14.0,2000,DF,15,3,18,22,66.7,33,11,26,0,9,38,6,19,47,13,20
7edfbb8a,Fikayo Tomori,25,Milan,Serie A,23.6,1997,DF,11,23,34,18,62.1,29,11,75,1,26,42,3,29,68,10,24
7ef972c3,Flavius Daniliuc,22,Salernitana,Serie A,8.3,2001,DF,9,4,13,9,47.4,19,10,15,0,8,19,2,12,27,5,11
7f14ec2a,Arsen Zakharyan,20,Real Sociedad,La Liga,13.6,2003,"MF,FW",16,0,16,9,40.9,22,13,10,0,4,22,3,8,26,11,15
7f267d66,Alessandro Deiola,27,Cagliari,Serie A,17.9,1995,MF,10,6,16,18,38.3,47,29,37,0,9,33,4,13,42,16,19
7f609bfc,Stefan Posch,26,Bologna,Serie A,26.8,1997,DF,19,8,27,49,55.7,88,39,72,0,18,77,4,35,95,38,46
7f73bdf4,Niklas Dorsch,25,Augsburg,Bundesliga,15.4,1998,MF,6,9,15,13,39.4,33,20,27,0,16,35,1,13,51,21,24
7f783431,Enzo Tchato,20,Montpellier,Ligue 1,12.5,2002,DF,13,7,20,11,44.0,25,14,25,0,11,26,4,18,37,4,17
7f78ad23,Ricardo Rodriguez,30,Torino,Serie A,30.8,1992,DF,13,9,22,28,62.2,45,17,64,2,24,45,2,21,69,22,26
7f94982c,Ethan Nwaneri,16,Arsenal,Premier League,0.2,2007,FW,1,0,1,0,"",0,0,0,0,0,0,0,0,0,0,0
7f9c5d2d,Abner,23,Betis,La Liga,15.6,2000,DF,18,5,23,17,50.0,34,17,62,0,15,25,1,15,40,9,19
7fa4e703,Gio Reyna,20,Dortmund,Bundesliga,3.1,2002,"MF,FW",4,1,5,2,40.0,5,3,5,0,2,9,2,3,11,4,6
7fac99d4,Razvan Marin,27,Empoli,Serie A,20.2,1996,MF,12,4,16,19,65.5,29,10,30,2,6,40,4,13,46,23,22
7fe90ccd,Davide Zappacosta,31,Atalanta,Serie A,20.7,1992,DF,25,4,29,16,47.1,34,18,19,0,5,30,5,15,35,10,20
8006228f,Ayyoub Bouaddi,15,Lille,Ligue 1,1.5,2007,MF,2,0,2,2,40.0,5,3,3,0,1,6,0,6,7,0,2
801831fe,Daniel Maldini,21,Empoli,Serie A,2.9,2001,"FW,MF",5,0,5,2,100.0,2,0,2,0,2,4,2,0,6,2,2
803ae100,Harrison Reed,28,Fulham,Premier League,14.7,1995,MF,10,9,19,13,41.9,31,18,24,0,11,29,3,9,40,17,18
80490d7f,Jhon Lucumi,25,Bologna,Serie A,24.6,1998,DF,15,17,32,27,75.0,36,9,68,2,16,48,0,31,64,17,29
80556f08,Toma Basic,26,Salernitana,Serie A,12.9,1996,MF,12,6,18,10,37.0,27,17,29,0,14,20,1,10,34,9,13
8059806f,Luiz Henrique,22,Betis,La Liga,6.8,2001,FW,11,0,11,9,64.3,14,5,8,0,5,15,1,4,20,10,11
808d48f3,Jaume Costa,35,Mallorca,La Liga,18.7,1988,DF,10,4,14,18,62.1,29,11,35,0,16,38,5,23,54,10,22
80dbbd10,Simeon Nwankwo,31,Salernitana,Serie A,7.6,1992,FW,7,0,7,1,33.3,3,2,4,0,0,6,4,0,6,2,3
80f252f6,Dzenan Pejcinovic,18,Wolfsburg,Bundesliga,0.4,2005,FW,1,0,1,0,"",0,0,0,0,0,0,0,0,0,0,0
8104e41e,Krepin Diatta,24,Monaco,Ligue 1,13.4,1999,"DF,FW",15,2,17,27,55.1,49,22,22,0,16,37,4,17,53,16,20
81442ecb,Marcos Acuna,31,Sevilla,La Liga,14.4,1991,DF,10,2,12,9,64.3,14,5,25,0,4,33,1,20,37,12,21
817c6964,Rade Krunic,29,Milan,Serie A,7.6,1993,MF,4,3,7,4,44.4,9,5,14,0,11,10,1,3,21,6,8
819aa8e7,Ayoze Perez,30,Betis,La Liga,25.5,1993,FW,38,4,42,21,42.9,49,28,18,0,22,59,10,16,81,33,32
819b3158,Ilkay Gundogan,32,Barcelona,La Liga,33.3,1990,MF,15,4,19,12,30.8,39,27,18,1,21,32,2,14,53,16,22
81f0781e,Gerard Moreno,31,Villarreal,La Liga,24.6,1992,FW,17,7,24,11,44.0,25,14,24,0,9,25,8,10,34,7,12
822b83e8,Ole Pohlmann,22,Dortmund,Bundesliga,0.6,2001,MF,0,0,0,1,50.0,2,1,1,0,0,1,0,0,1,1,0
822d51d7,Youssouf Fofana,24,Monaco,Ligue 1,30.0,1999,MF,28,7,35,30,45.5,66,36,31,1,37,61,6,19,98,36,39
822ed0ec,Valentin Gendrey,23,Lecce,Serie A,33.8,2000,DF,29,11,40,30,65.2,46,16,99,0,35,55,4,35,90,16,33
8236f673,Malick Fofana,18,Lyon,Ligue 1,6.2,2005,FW,3,0,3,4,44.4,9,5,9,0,5,5,1,3,10,1,4
82464ce3,Salis Abdul Samed,23,Lens,Ligue 1,16.9,2000,MF,11,1,12,8,44.4,18,10,18,0,12,21,3,8,33,10,14
82518f62,Bruno Guimaraes,25,Newcastle Utd,Premier League,36.3,1997,MF,38,14,52,40,51.9,77,37,20,0,35,88,11,45,123,32,53
82598b71,Nadir Zortea,24,Atalanta,Serie A,1.7,1999,DF,2,0,2,1,25.0,4,3,3,0,1,5,1,3,6,1,4
825ed0d1,Simon Elisor,24,Metz,Ligue 1,8.5,1999,FW,5,1,6,2,33.3,6,4,9,0,0,9,4,3,9,2,2
826e8b63,Philipp Max,29,Eint Frankfurt,Bundesliga,15.0,1993,DF,17,1,18,19,73.1,26,7,18,2,7,26,2,6,33,18,17
828657ff,Amadou Onana,21,Everton,Premier League,23.2,2001,MF,19,6,25,21,50.0,42,21,31,0,21,71,8,32,92,31,38
82927de4,Pablo Fornals,27,Betis,La Liga,12.8,1996,"FW,MF",14,0,14,12,54.5,22,10,10,2,22,24,5,8,46,11,16
829aa60c,Mathys Tel,18,Bayern Munich,Bundesliga,11.7,2005,"FW,MF",11,0,11,4,66.7,6,2,6,0,6,12,5,3,18,4,2
82bfc14d,Leart Paqarada,28,Köln,Bundesliga,11.9,1994,DF,12,5,17,11,50.0,22,11,30,1,10,21,3,9,31,9,11
82e12fe7,Junior Adamu,22,Freiburg,Bundesliga,1.2,2001,"FW,MF",1,0,1,1,50.0,2,1,2,0,0,5,2,1,5,2,1
82ec26c1,Lamine Yamal,16,Barcelona,La Liga,24.5,2007,FW,32,0,32,18,37.5,48,30,11,0,19,61,14,32,80,15,37
82f8d2f4,Zanos Savva,17,Torino,Serie A,0.3,2005,"DF,MF",0,0,0,1,33.3,3,2,1,0,0,1,0,0,1,1,1
83299cc0,Azzedine Ounahi,23,Marseille,Ligue 1,13.4,2000,MF,5,1,6,11,34.4,32,21,8,0,11,25,2,9,36,14,11
8332db56,Thomas Delaine,31,Strasbourg,Ligue 1,22.7,1992,"DF,MF",16,2,18,20,47.6,42,22,51,0,17,38,1,29,55,8,19
833fb62e,Sandro Ramirez,28,Las Palmas,La Liga,20.1,1995,FW,12,1,13,6,40.0,15,9,14,1,4,12,2,4,16,6,8
8388ba65,Yassin Tallal,18,Getafe,La Liga,0.0,2005,FW,0,0,0,0,"",0,0,0,0,0,0,0,0,0,0,0
8397a50c,Tyrone Mings,30,Aston Villa,Premier League,0.3,1993,DF,0,0,0,0,"",0,0,1,0,1,0,0,0,1,0,0
839c14e1,Cedric Soares,31,Arsenal,Premier League,0.7,1991,DF,0,0,0,0,"",0,0,0,0,0,0,0,0,0,0,0
83c06f3a,Lorenzo Lucca,22,Udinese,Serie A,28.8,2000,FW,15,3,18,5,25.0,20,15,36,1,3,19,4,4,22,11,11
83d074ff,Alexis Mac Allister,24,Liverpool,Premier League,28.9,1998,MF,57,8,65,59,47.2,125,66,25,1,35,99,14,35,134,50,55
83e1f40e,Luca Pfeiffer,26,Darmstadt 98,Bundesliga,18.0,1996,"FW,MF",4,1,5,5,45.5,11,6,21,0,2,11,3,2,13,6,6
83fe71b8,Tomas Suslov,21,Hellas Verona,Serie A,23.2,2002,"MF,FW",15,0,15,15,31.9,47,32,8,0,6,42,9,11,48,22,30
84399660,Juanmi,30,Cádiz,La Liga,9.7,1993,FW,6,0,6,2,22.2,9,7,3,0,6,9,0,2,15,7,4
8449d35e,Vitaly Janelt,25,Brentford,Premier League,33.9,1998,"MF,DF",26,9,35,32,50.0,64,32,64,3,36,63,9,29,99,25,38
8455ad90,Lee Kang-in,22,Paris S-G,Ligue 1,16.3,2001,"FW,MF",7,0,7,15,41.7,36,21,3,0,6,26,10,7,32,9,13
84c5ceea,Tim Iroegbunam,20,Aston Villa,Premier League,1.8,2003,MF,3,0,3,4,44.4,9,5,3,0,2,7,1,4,9,2,5
852ddfb8,Gaston Alvarez,23,Getafe,La Liga,28.2,2000,DF,29,11,40,37,64.9,57,20,80,0,35,68,5,43,103,20,37
853ca71c,Anastasios Douvikas,23,Celta Vigo,La Liga,10.1,1999,FW,3,3,6,3,37.5,8,5,9,0,2,15,7,2,17,6,7
854ee61a,Gregoire Defrel,32,Sassuolo,Serie A,8.4,1991,"FW,MF",10,0,10,7,46.7,15,8,9,0,3,17,5,7,20,5,8
85613cf0,Arkadiusz Milik,29,Juventus,Serie A,10.2,1994,FW,6,1,7,3,60.0,5,2,3,0,5,9,2,2,14,5,5
8575037f,Fabian Schnellhardt,29,Darmstadt 98,Bundesliga,2.6,1994,MF,1,0,1,1,33.3,3,2,5,0,4,4,1,2,8,1,1
8577e60a,Mahdi Camara,25,Brest,Ligue 1,22.4,1998,MF,23,1,24,20,40.8,49,29,19,0,27,55,7,8,82,40,39
857a5abe,Stefan Bell,31,Mainz 05,Bundesliga,7.4,1991,DF,2,5,7,4,50.0,8,4,30,0,6,8,0,7,14,1,8
857cb4f3,Peru Nolaskoain,24,Athletic Club,La Liga,0.1,1998,"DF,MF",0,0,0,1,100.0,1,0,1,0,0,1,0,1,1,0,1
8593f88c,Christian Gunter,30,Freiburg,Bundesliga,11.8,1993,DF,6,3,9,7,38.9,18,11,16,0,2,20,0,9,22,11,12
85a44ecc,Lassana Coulibaly,27,Salernitana,Serie A,23.1,1996,MF,18,5,23,22,44.9,49,27,29,0,16,47,6,20,63,21,32
85b6462d,Aaron Seydel,27,Darmstadt 98,Bundesliga,6.9,1996,FW,6,2,8,0,0.0,3,3,9,0,1,3,1,0,4,2,2
85bed4ee,Rodri,23,Betis,La Liga,11.7,2000,"FW,MF",11,0,11,8,38.1,21,13,2,0,8,17,4,6,25,7,10
85f476cc,Oussama El Azzouzi,22,Bologna,Serie A,6.1,2001,MF,6,2,8,7,50.0,14,7,12,0,6,12,3,4,18,5,7
85f7d1be,Pierre Kalulu,23,Milan,Serie A,4.2,2000,DF,1,3,4,1,50.0,2,1,12,1,1,5,0,2,6,3,1
85f7ed25,Daniel Boloca,24,Sassuolo,Serie A,22.5,1998,MF,10,13,23,27,58.7,46,19,33,2,14,48,5,18,62,25,33
86087757,Federico Gattoni,24,Sevilla,La Liga,0.1,1999,"DF,FW",0,0,0,1,100.0,1,0,1,0,0,1,0,1,1,0,0
861e9b3b,Daniel Gore,18,Manchester Utd,Premier League,0.0,2004,MF,0,0,0,1,100.0,1,0,0,0,1,1,0,0,2,1,1
862a1c15,Miguel Almiron,29,Newcastle Utd,Premier League,21.5,1994,FW,27,2,29,11,37.9,29,18,13,0,10,36,8,13,46,15,24
86383d0e,Martin Satriano,22,Brest,Ligue 1,20.7,2001,FW,12,7,19,10,40.0,25,15,28,0,7,24,5,6,31,13,16
8650af85,Gian Marco Ferrari,31,Sassuolo,Serie A,25.2,1992,DF,11,17,28,12,66.7,18,6,76,0,25,22,0,11,47,11,10
8652a85c,Lois Openda,23,RB Leipzig,Bundesliga,30.0,2000,FW,16,3,19,0,0.0,6,6,14,0,5,3,2,0,8,1,3
86574238,Manu Kone,22,Gladbach,Bundesliga,17.3,2001,MF,21,1,22,17,68.0,25,8,16,1,15,45,5,20,60,20,26
867239d3,Paul Pogba,30,Juventus,Serie A,0.6,1993,MF,0,0,0,1,100.0,1,0,1,0,1,1,0,0,2,1,1
868eaba0,Johan Gastien,35,Clermont Foot,Ligue 1,25.1,1988,MF,22,9,31,23,28.4,81,58,24,4,36,43,4,18,79,21,22
8696bc90,Munir El Haddadi,27,Las Palmas,La Liga,27.2,1995,FW,26,1,27,17,44.7,38,21,16,0,11,40,5,18,51,17,27
86a2ba20,Rominigue Kouame,26,Cádiz,La Liga,9.1,1996,MF,8,2,10,7,46.7,15,8,10,1,13,14,1,6,27,7,9
86adbcc7,Mathias Olesen,22,Köln,Bundesliga,1.2,2001,"MF,FW",0,0,0,0,"",0,0,2,0,2,0,0,0,2,0,0
86c75897,Ivan Ordets,31,Bochum,Bundesliga,20.9,1992,DF,12,29,41,10,58.8,17,7,130,0,31,19,2,11,50,6,14
86dd77d1,Kyle Walker,33,Manchester City,Premier League,30.7,1990,DF,13,6,19,19,48.7,39,20,40,1,27,38,2,19,65,17,24
86e119e0,Maximilian Arnold,29,Wolfsburg,Bundesliga,27.8,1994,MF,19,4,23,28,49.1,57,29,60,0,24,51,9,15,75,27,31
86e7deaf,Thiago Silva,38,Chelsea,Premier League,28.1,1984,DF,9,24,33,20,58.8,34,14,153,4,26,29,1,22,55,6,15
86ff856b,Lazaro,21,Almería,La Liga,3.2,2002,"FW,MF",4,0,4,2,25.0,8,6,1,0,1,4,2,2,5,0,1
87278bce,Dean Huijsen,18,Juventus,Serie A,0.1,2005,DF,0,0,0,0,"",0,0,1,0,0,0,0,0,0,0,0
873619c6,Sergio Camello,22,Rayo Vallecano,La Liga,18.5,2001,FW,8,2,10,6,40.0,15,9,15,0,3,16,3,3,19,10,5
8779ddf8,Florian Dietz,24,Köln,Bundesliga,0.8,1998,"FW,MF",1,0,1,0,"",0,0,0,0,0,0,0,0,0,0,0
877bc844,Philipp Hofmann,30,Bochum,Bundesliga,17.5,1993,FW,9,2,11,4,57.1,7,3,17,0,4,10,1,4,14,5,5
8790f988,Gianluca Scamacca,24,Atalanta,Serie A,16.1,1999,FW,6,1,7,7,50.0,14,7,9,0,4,15,6,4,19,5,9
87935cf3,Mamadou Sakho,33,Montpellier,Ligue 1,0.1,1990,DF,0,0,0,1,100.0,1,0,1,0,0,1,0,1,1,0,1
8794e251,Adrien Rabiot,28,Juventus,Serie A,29.5,1995,MF,20,6,26,30,66.7,45,15,34,0,25,58,6,22,83,30,39
87d31635,Aiman Maurer,18,Clermont Foot,Ligue 1,0.6,2004,"MF,FW",0,0,0,1,33.3,3,2,0,0,0,1,0,1,1,0,1
88050721,Unai Lopez,27,Rayo Vallecano,La Liga,23.4,1995,MF,21,3,24,21,39.6,53,32,15,2,16,48,7,18,64,23,24
8846a40f,Mathias Pereira Lage,26,Brest,Ligue 1,13.2,1996,"FW,MF",9,5,14,7,25.0,28,21,13,0,10,21,6,7,31,8,15
886f9aac,Manor Solomon,24,Tottenham,Premier League,2.2,1999,FW,4,0,4,1,50.0,2,1,2,0,3,3,1,1,6,1,3
88968486,Illia Zabarnyi,20,Bournemouth,Premier League,37.0,2002,DF,19,34,53,23,46.0,50,27,143,4,33,59,1,29,92,29,32
88acf83f,Reda Khadra,22,Reims,Ligue 1,15.2,2001,"FW,MF",6,2,8,8,40.0,20,12,13,0,3,16,7,5,19,4,10
88c4d190,Jeremy Le Douaron,25,Brest,Ligue 1,18.0,1998,FW,13,1,14,11,42.3,26,15,10,0,2,21,5,7,23,9,10
88d4144a,Maximilian Mittelstadt,26,Stuttgart,Bundesliga,23.4,1997,DF,30,6,36,53,59.6,89,36,65,0,46,91,6,46,137,39,51
88e357ef,Serge Gnabry,28,Bayern Munich,Bundesliga,4.8,1995,"FW,MF",5,0,5,2,15.4,13,11,2,0,3,8,3,0,11,5,5
88f130ed,Jean-Clair Todibo,23,Nice,Ligue 1,29.5,1999,DF,19,15,34,34,60.7,56,22,97,1,38,58,6,35,96,17,28
890f108d,Youssef Chermiti,19,Everton,Premier League,2.3,2004,FW,3,1,4,1,20.0,5,4,2,0,1,3,0,2,4,1,2
89976232,Armando Izzo,31,Monza,Serie A,18.3,1992,DF,4,16,20,16,59.3,27,11,49,1,27,27,1,17,54,9,17
89ac64a6,Manuel Akanji,28,Manchester City,Premier League,27.9,1995,"DF,MF",16,12,28,22,56.4,39,17,70,3,23,42,8,16,65,18,28
89f951b5,Ivan Rakitic,35,Sevilla,La Liga,15.8,1988,MF,11,5,16,11,57.9,19,8,12,0,14,30,9,9,44,12,16
8a3c1dc7,Rico Henry,26,Brentford,Premier League,4.5,1997,DF,5,3,8,6,85.7,7,1,5,1,5,7,1,3,12,3,5
8a6de8c7,Lameck Banda,22,Lecce,Serie A,15.0,2001,FW,18,0,18,7,33.3,21,14,7,0,3,27,4,11,30,12,23
8a7ff278,Joel Ward,33,Crystal Palace,Premier League,22.0,1989,DF,7,10,17,30,63.8,47,17,94,1,14,45,1,26,59,18,28
8a958856,Arthur,20,Leverkusen,Bundesliga,2.0,2003,DF,0,1,1,2,100.0,2,0,7,0,0,4,2,2,4,0,3
8aae94b9,Mamadou Mbaye,25,Cádiz,La Liga,3.2,1998,DF,3,7,10,2,40.0,5,3,26,0,5,6,0,3,11,3,3
8aafd64f,Joao Felix,23,Barcelona,La Liga,17.1,1999,FW,13,1,14,8,36.4,22,14,11,0,10,22,6,9,32,7,16
8ae7d0ec,Assane Diao,17,Betis,La Liga,11.6,2005,FW,18,4,22,6,35.3,17,11,7,0,7,20,6,5,27,9,12
8aec0537,Pascal Gross,32,Brighton,Premier League,34.6,1991,"MF,DF",33,8,41,31,43.1,72,41,32,3,22,70,16,33,92,21,46
8aff2b51,Michael Ndiweni,19,Newcastle Utd,Premier League,0.0,2003,FW,0,0,0,0,"",0,0,0,0,0,0,0,0,0,0,0
8b04d6c1,Pierre Hojbjerg,27,Tottenham,Premier League,14.6,1995,MF,14,7,21,13,38.2,34,21,30,3,19,32,2,13,51,17,18
8b3ab7ad,Edson Alvarez,25,West Ham,Premier League,26.4,1997,MF,39,20,59,31,47.0,66,35,81,0,42,80,7,47,122,26,39
8b529245,Carlos Vinicius,28,Fulham,Premier League,3.5,1995,FW,4,0,4,0,0.0,4,4,1,0,0,3,2,0,3,1,2
8b57ad2c,Joao Gomes,22,Wolves,Premier League,29.4,2001,MF,43,8,51,44,44.4,99,55,29,2,18,128,12,67,146,49,74
8b609c34,Wilfried Singo,22,Monaco,Ligue 1,24.3,2000,DF,13,14,27,17,65.4,26,9,81,2,51,34,2,18,85,14,25
8b66d9cc,Yann Karamoh,25,Montpellier,Ligue 1,3.2,1998,"FW,MF",3,0,3,1,50.0,2,1,0,0,0,1,1,0,1,0,0
8b788c01,Anthony Martial,27,Manchester Utd,Premier League,5.0,1995,FW,4,0,4,1,100.0,1,0,3,0,0,4,2,1,4,1,1
8b84b707,Julian Malatini,22,Werder Bremen,Bundesliga,6.7,2001,DF,7,1,8,16,66.7,24,8,26,0,13,18,3,12,31,3,13
8b8a56ce,Simon Kjaer,34,Milan,Serie A,13.0,1989,DF,6,16,22,14,63.6,22,8,46,2,14,24,2,11,38,11,15
8b9ebd03,Willian,34,Fulham,Premier League,22.8,1988,FW,13,0,13,3,14.3,21,18,12,1,9,18,5,6,27,7,11
8bbe2df5,Domagoj Bradaric,23,Salernitana,Serie A,30.5,1999,DF,15,7,22,15,60.0,25,10,62,1,32,29,6,13,61,10,20
8bc8829a,Lucien Agoume,21,Sevilla,La Liga,8.6,2002,MF,5,1,6,9,75.0,12,3,8,0,7,23,2,7,30,14,18
8bfbf257,Mahamadou Nagida,18,Rennes,Ligue 1,1.2,2005,DF,1,1,2,0,0.0,2,2,0,0,4,1,1,0,5,0,1
8c3078cd,Luke Harris,18,Fulham,Premier League,0.8,2005,MF,0,0,0,0,0.0,1,1,0,0,0,1,0,1,1,0,1
8c3c640c,Mikel Oyarzabal,26,Real Sociedad,La Liga,24.0,1997,"FW,MF",21,4,25,7,33.3,21,14,12,0,4,23,5,7,27,11,18
8c4b95af,David Akpan Ankeye,21,Genoa,Serie A,0.6,2002,FW,1,0,1,0,0.0,1,1,0,0,0,1,0,0,1,1,0
8c4e56cb,Francisco Jesus Crespo Garcia,27,Las Palmas,La Liga,5.6,1996,FW,4,0,4,6,33.3,18,12,5,0,2,12,3,3,14,6,8
8c63fae5,Luca Ranieri,24,Fiorentina,Serie A,22.9,1999,DF,14,11,25,8,61.5,13,5,64,0,29,14,2,11,43,1,10
8c6d0e32,Borja Vazquez,18,Cádiz,La Liga,0.0,2005,FW,0,0,0,1,100.0,1,0,1,0,0,1,0,1,1,0,0
8c725b43,German Pezzella,32,Betis,La Liga,30.7,1991,DF,13,18,31,23,60.5,38,15,150,0,31,34,0,24,65,10,24
8c90fd7a,Victor Osimhen,24,Napoli,Serie A,22.0,1998,FW,4,1,5,2,50.0,4,2,18,0,2,9,5,0,11,4,5
8ca358c5,Victor Parada,21,Alavés,La Liga,0.0,2002,"FW,MF",0,0,0,1,100.0,1,0,0,0,0,1,0,0,1,1,1
8d3c902d,Cheikhou Kouyate,33,"Nott'ham Forest",Premier League,2.4,1989,MF,3,1,4,1,25.0,4,3,10,0,2,8,2,3,10,3,5
8d3cd59d,Carlos Augusto,24,Inter,Serie A,19.2,1999,DF,12,8,20,15,68.2,22,7,52,0,16,29,0,20,45,9,21
8d47bb39,Carlos Neva,27,Granada,La Liga,35.0,1996,DF,25,14,39,17,42.5,40,23,108,2,30,32,1,22,62,9,21
8d78e732,Robert Lewandowski,34,Barcelona,La Liga,30.6,1988,FW,9,4,13,4,33.3,12,8,18,0,9,8,2,0,17,6,5
8da74c05,Adrien Tameze,29,Torino,Serie A,23.8,1994,"DF,MF",13,11,24,18,48.6,37,19,25,2,47,35,4,13,82,18,16
8daee720,Simone Pafundi,17,Udinese,Serie A,0.1,2006,MF,0,0,0,0,"",0,0,0,0,0,0,0,0,0,0,0
8df7a2fb,Ben Mee,33,Brentford,Premier League,14.1,1989,DF,8,13,21,17,77.3,22,5,63,1,13,26,2,12,39,12,15
8e088e04,Toni Lato,25,Mallorca,La Liga,17.2,1997,DF,14,3,17,16,59.3,27,11,27,0,17,38,6,19,55,13,23
8e16dd48,Luis Sinisterra,24,Bournemouth,Premier League,7.8,1999,"FW,MF",18,0,18,9,56.3,16,7,4,0,8,23,4,9,31,10,12
8e235926,Michael Gregoritsch,29,Freiburg,Bundesliga,18.7,1994,FW,13,4,17,2,14.3,14,12,27,0,9,16,3,8,25,5,12
8e48dc61,Ander Guevara,26,Alavés,La Liga,32.6,1997,MF,22,12,34,31,48.4,64,33,46,1,13,59,6,28,72,25,32
8e633970,Lewis Warrington,20,Everton,Premier League,0.0,2002,FW,0,0,0,0,"",0,0,0,0,0,0,0,0,0,0,0
8e697a8f,Dan Ndoye,22,Bologna,Serie A,19.7,2000,"FW,MF",19,1,20,17,43.6,39,22,14,0,10,30,2,17,40,11,15
8e92be30,Alexander Isak,23,Newcastle Utd,Premier League,25.1,1999,FW,15,1,16,2,25.0,8,6,13,0,6,5,2,2,11,1,0
8eb55dbb,Sheraldo Becker,28,Union Berlin,Bundesliga,7.2,1995,"FW,MF",2,0,2,0,0.0,2,2,2,0,0,3,1,0,3,2,3
8eb5c94c,Nnamdi Collins,19,Eint Frankfurt,Bundesliga,1.0,2004,DF,0,0,0,0,"",0,0,4,0,2,0,0,0,2,0,0
8ec109e6,Caleb Okoli,22,Frosinone,Serie A,32.4,2001,DF,16,32,48,29,65.9,44,15,156,4,29,56,1,33,85,22,34
8eec784d,Timothy Weah,23,Juventus,Serie A,14.0,2000,"DF,FW",11,1,12,15,75.0,20,5,15,0,5,27,3,16,32,8,20
8f056768,Xaver Schlager,25,RB Leipzig,Bundesliga,27.5,1997,MF,33,8,41,21,39.6,53,32,27,0,19,81,8,35,100,38,50
8f325097,Nicolas Cozza,24,Wolfsburg,Bundesliga,3.1,1999,DF,3,0,3,2,28.6,7,5,6,0,4,8,0,4,12,4,6
8f3565b3,Ante Budimir,32,Osasuna,La Liga,27.1,1991,FW,14,5,19,5,35.7,14,9,18,0,5,21,8,2,26,11,15
8f4541c2,Julian Araujo,21,Las Palmas,La Liga,16.2,2001,DF,7,16,23,23,69.7,33,10,52,1,10,41,5,29,51,7,22
8f5e92a6,Rodrygo,22,Real Madrid,La Liga,26.4,2001,FW,14,0,14,5,26.3,19,14,6,0,8,16,5,2,24,9,15
8f696594,Memphis,29,Atlético Madrid,La Liga,9.9,1994,FW,2,0,2,3,50.0,6,3,0,0,1,5,2,0,6,3,2
8fd9996f,Danilo Pereira,31,Paris S-G,Ligue 1,22.2,1991,DF,3,26,29,9,52.9,17,8,100,1,23,22,2,14,45,6,12
8fe2a392,Micky van de Ven,22,Tottenham,Premier League,26.0,2001,DF,10,15,25,24,72.7,33,9,78,1,18,49,3,34,67,12,35
907a5d7c,Yehor Yarmoliuk,19,Brentford,Premier League,7.6,2004,MF,13,4,17,7,41.2,17,10,5,0,6,17,3,6,23,8,11
90bbd822,Alvaro Garcia,30,Rayo Vallecano,La Liga,27.5,1992,"FW,MF",35,0,35,7,20.6,34,27,33,0,36,34,9,15,70,10,25
90df343e,Carlos Vicente,24,Alavés,La Liga,12.4,1999,FW,4,0,4,10,40.0,25,15,9,0,4,16,2,7,20,7,6
90eb507d,Thomas Foket,28,Reims,Ligue 1,20.4,1994,DF,22,12,34,20,44.4,45,25,36,0,25,32,3,21,57,8,17
90f91999,John McGinn,28,Aston Villa,Premier League,33.3,1994,"MF,FW",29,4,33,32,41.6,77,45,21,0,21,59,7,18,80,34,35
90fcf472,Wesley Said,28,Lens,Ligue 1,11.3,1995,"FW,MF",4,0,4,2,22.2,9,7,3,0,4,8,5,1,12,2,4
911080b1,Luigi Canotto,29,Frosinone,Serie A,0.2,1994,FW,0,0,0,0,"",0,0,0,0,0,0,0,0,0,0,0
914ab9a1,Christian Kabasele,32,Udinese,Serie A,9.6,1991,DF,6,9,15,2,18.2,11,9,56,0,12,10,1,4,22,5,7
914bb955,Christopher Operi,26,Le Havre,Ligue 1,27.2,1997,DF,38,7,45,32,54.2,59,27,68,1,35,55,3,37,90,15,36
91748070,Teden Mengi,21,Luton Town,Premier League,27.4,2002,DF,12,27,39,19,63.3,30,11,140,1,57,54,1,33,111,20,22
91d0fabf,Riccardo Marchizza,25,Frosinone,Serie A,12.8,1998,DF,8,2,10,3,23.1,13,10,33,0,7,7,0,4,14,3,6
91f04b44,Benjamin Tetteh,26,Metz,Ligue 1,3.1,1997,"FW,MF",0,0,0,4,57.1,7,3,1,0,0,6,0,1,6,5,6
91f7631f,Inigo Ruiz de Galarreta,29,Athletic Club,La Liga,23.2,1993,MF,13,5,18,24,49.0,49,25,17,0,12,49,8,15,61,26,31
91ff775f,Nicolo Cambiaghi,22,Empoli,Serie A,28.4,2000,"FW,MF",25,1,26,16,45.7,35,19,8,0,14,51,16,15,65,20,39
921f6058,Jose Luis Palomino,33,Atalanta,Serie A,0.3,1990,DF,1,1,2,1,100.0,1,0,6,0,1,2,0,1,3,1,1
9226aa22,Kamory Doumbia,20,Brest,Ligue 1,9.8,2003,MF,14,0,14,10,34.5,29,19,6,0,9,28,10,8,37,10,18
9228b07c,Tom Davies,25,Sheffield Utd,Premier League,2.5,1998,MF,1,1,2,3,33.3,9,6,6,1,3,10,3,4,13,3,5
922dfade,Crespo,26,Rayo Vallecano,La Liga,5.9,1996,MF,9,6,15,9,52.9,17,8,7,0,10,16,2,8,26,6,9
923f4dda,Serhou Guirassy,27,Stuttgart,Bundesliga,24.5,1996,FW,7,1,8,2,40.0,5,3,29,0,6,6,1,1,12,4,3
92432bc6,Amadou Haidara,25,RB Leipzig,Bundesliga,17.0,1998,MF,22,6,28,23,56.1,41,18,37,0,21,42,2,24,63,16,27
924f9191,Grischa Promel,28,Hoffenheim,Bundesliga,23.8,1995,MF,16,6,22,14,43.8,32,18,36,0,22,32,6,11,54,15,18
928143e7,Elayis Tavsan,22,Hellas Verona,Serie A,0.6,2001,"MF,FW",0,0,0,0,0.0,1,1,1,0,0,0,0,0,0,0,0
92868cb5,Divin Mubama,18,West Ham,Premier League,0.9,2004,FW,0,0,0,0,"",0,0,0,0,0,0,0,0,0,0,0
928a4a61,Jens Cajuste,23,Napoli,Serie A,11.3,1999,MF,17,3,20,20,54.1,37,17,15,0,4,36,6,13,40,17,24
9295dc1c,Vitinho,24,Burnley,Premier League,25.7,1999,"DF,MF",38,6,44,43,50.0,86,43,47,4,12,64,6,36,76,22,34
92a16062,Eric Martel,21,Köln,Bundesliga,27.3,2002,MF,46,19,65,37,55.2,67,30,80,0,43,70,4,32,113,34,43
92d83c27,Mattias Svanberg,24,Wolfsburg,Bundesliga,19.1,1999,MF,20,5,25,12,31.6,38,26,28,0,21,37,10,8,58,19,17
92d90c8f,Sirine Doucoure,21,Lorient,Ligue 1,4.7,2002,FW,4,0,4,3,100.0,3,0,6,0,1,8,4,0,9,4,6
92e7e919,Son Heung-min,31,Tottenham,Premier League,32.6,1992,FW,3,1,4,10,47.6,21,11,4,0,8,21,8,6,29,7,13
92ffb8f9,Vincent Sierro,27,Toulouse,Ligue 1,25.1,1995,MF,24,13,37,27,35.1,77,50,33,0,27,41,6,15,68,20,24
93090f69,Domingos Duarte,28,Getafe,La Liga,10.1,1995,DF,2,5,7,5,71.4,7,2,27,0,8,7,1,6,15,0,4
9319781b,Ben Johnson,23,West Ham,Premier League,6.0,2000,"DF,FW",1,1,2,9,64.3,14,5,14,0,5,11,1,7,16,3,7
932bfcac,Jan Schoppner,24,Heidenheim,Bundesliga,22.2,1999,MF,30,7,37,21,50.0,42,21,57,0,26,48,2,26,74,20,26
933d3b51,Koffi Djidji,30,Torino,Serie A,8.4,1992,DF,5,5,10,3,75.0,4,1,20,0,10,14,0,9,24,5,9
934e1968,Dominik Szoboszlai,22,Liverpool,Premier League,23.4,2000,MF,35,2,37,16,32.0,50,34,16,1,15,32,8,12,47,12,19
938d8a55,Giovanni Bonfanti,20,Atalanta,Serie A,1.0,2003,DF,0,1,1,2,66.7,3,1,1,0,1,4,0,2,5,2,2
938fa024,Brandon Aguilera,20,"Nott'ham Forest",Premier League,0.1,2003,FW,0,0,0,0,"",0,0,0,0,0,0,0,0,0,0,0
93a50d2c,Kasim Nuhu,28,Hoffenheim,Bundesliga,0.1,1995,DF,0,0,0,0,"",0,0,0,0,0,0,0,0,0,0,0
93a8c4f9,Lukas Daschner,24,Bochum,Bundesliga,6.0,1998,"MF,FW",7,0,7,4,44.4,9,5,2,0,2,9,4,2,11,3,4
93c942fb,Theo Sainte-Luce,24,Montpellier,Ligue 1,3.8,1998,DF,5,4,9,11,57.9,19,8,15,0,3,17,1,10,20,6,7
93e08bce,Ameen Al-Dakhil,21,Burnley,Premier League,11.7,2002,DF,7,6,13,1,10.0,10,9,38,2,12,12,1,4,24,7,5
942b4f90,Wissam Ben Yedder,32,Monaco,Ligue 1,25.7,1990,FW,18,0,18,1,9.1,11,10,1,0,8,4,1,1,12,2,3
94302c52,Timo Hubers,27,Köln,Bundesliga,30.9,1996,DF,26,28,54,49,61.3,80,31,168,1,63,68,3,51,131,14,47
94816803,Riccardo Sottil,24,Fiorentina,Serie A,12.3,1999,FW,12,0,12,3,37.5,8,5,2,0,2,10,4,5,12,1,5
94acdd4e,Sergi Altimira,21,Betis,La Liga,6.3,2001,MF,11,1,12,11,47.8,23,12,10,0,9,15,1,8,24,6,8
94b2001f,Danilo,32,Juventus,Serie A,27.2,1991,DF,19,15,34,32,66.7,48,16,94,0,37,60,4,38,97,18,36
94bccc82,Natan,22,Napoli,Serie A,10.6,2001,DF,3,9,12,5,50.0,10,5,32,0,8,14,1,10,22,3,10
94c18565,Florian Kainz,30,Köln,Bundesliga,24.4,1992,"MF,FW",14,6,20,17,43.6,39,22,23,1,13,28,7,8,41,13,20
94e01ec6,Jesus Areso,24,Osasuna,La Liga,29.6,1999,DF,21,15,36,31,81.6,38,7,58,0,18,45,7,25,63,13,24
94f8d10c,Duje Caleta-Car,26,Lyon,Ligue 1,22.1,1996,DF,13,14,27,18,81.8,22,4,94,1,18,26,1,19,44,6,11
957e4c87,Giulio Maggiore,25,Salernitana,Serie A,20.0,1998,MF,22,5,27,20,47.6,42,22,38,0,24,49,1,26,73,22,29
958d67bb,Miguel Rodriguez,20,Celta Vigo,La Liga,3.3,2003,MF,8,0,8,3,33.3,9,6,0,0,4,6,2,3,10,1,3
95bb6ddc,Junior Dina Ebimbe,22,Eint Frankfurt,Bundesliga,21.7,2000,"MF,DF",21,7,28,18,43.9,41,23,39,1,9,44,12,15,53,17,29
95bd120d,Deivid Washington,18,Chelsea,Premier League,0.1,2005,"DF,FW",0,0,0,0,0.0,1,1,0,0,0,1,0,1,1,0,1
95facda1,Nahitan Nandez,27,Cagliari,Serie A,26.0,1995,"MF,DF",23,2,25,27,42.2,64,37,32,0,19,59,9,27,78,23,40
962e54cb,Goncalo Paciencia,28,Bochum,Bundesliga,7.2,1994,"FW,MF",5,0,5,3,50.0,6,3,7,0,0,8,4,2,8,2,4
963829d0,Manu Trigueros,31,Villarreal,La Liga,3.4,1991,MF,0,1,1,4,40.0,10,6,9,0,3,7,0,6,10,1,5
96593e89,James Mcatee,20,Manchester City,Premier League,0.0,2002,MF,1,0,1,0,"",0,0,0,0,0,0,0,0,0,0,0
9662c9ec,Patrick Osterhage,23,Bochum,Bundesliga,20.7,2000,MF,27,9,36,17,47.2,36,19,32,1,27,38,1,14,65,23,26
966e28d0,Fabio Carvalho,20,RB Leipzig,Bundesliga,1.8,2002,MF,8,0,8,1,33.3,3,2,1,0,0,3,1,0,3,2,1
966eea58,Sandi Lovric,25,Udinese,Serie A,22.1,1998,MF,19,2,21,9,39.1,23,14,24,0,21,25,5,9,46,11,12
96726741,Loris Mouyokolo,22,Lorient,Ligue 1,1.0,2001,DF,1,0,1,1,100.0,1,0,3,0,0,4,0,4,4,0,1
9674002f,Mason Mount,24,Manchester Utd,Premier League,5.7,1999,"MF,FW",5,1,6,6,37.5,16,10,3,0,6,22,6,6,28,10,14
967ac202,Paulo Azzi,29,Cagliari,Serie A,10.6,1994,"DF,MF",9,2,11,9,50.0,18,9,23,0,16,19,3,10,35,6,11
968a1c2f,Oier Zarraga,24,Udinese,Serie A,4.5,1999,MF,3,2,5,1,20.0,5,4,16,1,5,3,0,2,8,1,3
96cfb5e2,Fabian Rudlin,26,Freiburg,Bundesliga,0.1,1997,MF,0,0,0,0,"",0,0,0,0,0,1,1,0,1,0,0
96e0490d,Matteo Darmian,33,Inter,Serie A,26.7,1989,DF,16,11,27,20,37.7,53,33,55,0,13,48,10,23,61,15,22
970b8574,Federico Dimarco,25,Inter,Serie A,23.1,1997,DF,15,3,18,17,48.6,35,18,34,1,9,42,9,19,51,14,25
972183e0,Abdellah Baallal,18,Clermont Foot,Ligue 1,0.0,2004,MF,1,0,1,0,"",0,0,0,0,0,0,0,0,0,0,0
97220da2,Armando Broja,21,Fulham,Premier League,1.0,2001,FW,1,0,1,0,"",0,0,0,0,0,0,0,0,0,0,0
972aeb2a,William Saliba,22,Arsenal,Premier League,38.0,2001,DF,15,17,32,20,74.1,27,7,81,3,29,41,1,28,70,12,26
974322dc,Iglesias,25,Getafe,La Liga,15.7,1998,"DF,FW",11,7,18,21,63.6,33,12,53,0,16,41,5,25,57,11,22
9744ff80,Pablo Sarabia,31,Wolves,Premier League,19.4,1992,"MF,FW",16,1,17,12,33.3,36,24,9,0,10,20,4,8,30,8,13
979b811d,Ivan Cavaleiro,29,Lille,Ligue 1,8.6,1993,FW,7,2,9,7,35.0,20,13,6,0,5,10,3,3,15,4,6
97d545ae,Ko Itakura,26,Gladbach,Bundesliga,17.7,1997,"DF,MF",14,18,32,16,61.5,26,10,62,0,22,34,2,17,56,15,21
980522ec,Christian Eriksen,31,Manchester Utd,Premier League,12.7,1992,MF,11,6,17,12,36.4,33,21,13,0,4,18,3,5,22,10,13
9823be92,Samuele Ricci,21,Torino,Serie A,26.6,2001,MF,18,3,21,15,65.2,23,8,25,0,27,33,4,17,60,12,18
983ff2c7,Lorenzo Venuti,28,Lecce,Serie A,4.0,1995,DF,1,3,4,6,60.0,10,4,14,0,5,6,0,5,11,1,4
986693ed,Francesco Gelli,26,Frosinone,Serie A,17.3,1996,"MF,DF",16,3,19,10,41.7,24,14,27,1,11,19,7,8,30,4,13
98a84572,Emil Ceide,21,Sassuolo,Serie A,2.0,2001,"FW,MF",5,1,6,1,100.0,1,0,0,0,0,2,0,1,2,1,2
98d2c2c4,Remo Freuler,31,Bologna,Serie A,29.2,1992,MF,28,9,37,38,55.1,69,31,53,2,36,78,5,41,114,32,50
9907b1c8,Nicolo Zaniolo,24,Aston Villa,Premier League,9.3,1999,"FW,MF",13,0,13,9,52.9,17,8,11,0,1,19,2,10,20,7,9
99127249,Antony,23,Manchester Utd,Premier League,14.7,2000,FW,28,1,29,20,50.0,40,20,9,0,12,40,6,15,52,19,21
9939e168,Jon Moncayola,25,Osasuna,La Liga,20.0,1998,MF,26,5,31,17,40.5,42,25,21,0,15,27,3,14,42,10,18
997fff07,Sebastiano Luperto,26,Empoli,Serie A,37.8,1996,DF,11,35,46,15,62.5,24,9,157,1,32,37,2,25,69,10,26
99813635,Adam Lallana,35,Brighton,Premier League,9.4,1988,"MF,FW",1,1,2,0,0.0,4,4,1,0,3,8,0,4,11,4,3
999ceb5f,Boubacar Traore,21,Wolves,Premier League,9.1,2001,MF,10,2,12,9,42.9,21,12,7,0,5,35,2,16,40,17,23
99f7e9aa,Pascal Stenzel,27,Stuttgart,Bundesliga,11.8,1996,DF,14,8,22,10,33.3,30,20,26,0,15,18,2,7,33,9,8
9a0408b6,Pathe Ciss,29,Rayo Vallecano,La Liga,18.5,1994,MF,17,10,27,16,55.2,29,13,54,0,30,44,2,16,74,26,24
9a28eba4,Adama Traore,27,Fulham,Premier League,4.2,1996,"FW,MF",2,0,2,3,50.0,6,3,2,0,1,4,1,1,5,2,3
9a2e0ccc,Emil Forsberg,31,RB Leipzig,Bundesliga,5.2,1991,"MF,FW",7,0,7,5,41.7,12,7,5,0,0,7,0,2,7,5,3
9a2e3a23,Dion Drena Beljo,21,Augsburg,Bundesliga,6.5,2002,"FW,MF",7,1,8,0,0.0,2,2,4,0,1,0,0,0,1,0,0
9a64e67e,Robin Le Normand,26,Real Sociedad,La Liga,27.4,1996,DF,11,15,26,17,56.7,30,13,96,1,28,31,0,16,59,15,22
9a76c2e9,"Javi Hernandez ",25,Cádiz,La Liga,27.9,1998,DF,25,9,34,25,54.3,46,21,72,1,19,43,5,26,62,12,24
9a796115,Abderrahman Rebbach,24,Alavés,La Liga,8.0,1998,"FW,MF",9,1,10,5,33.3,15,10,7,0,3,9,3,4,12,2,5
9a93efc9,Cenk Ozkacar,22,Valencia,La Liga,17.8,2000,DF,11,7,18,15,65.2,23,8,84,1,18,26,0,22,44,4,15
9ab16552,Makoto Hasebe,39,Eint Frankfurt,Bundesliga,2.4,1984,"DF,MF",1,1,2,3,50.0,6,3,5,0,2,4,0,2,6,2,2
9ace87ba,Javier Rueda Garcia,21,Celta Vigo,La Liga,0.2,2002,"MF,DF",0,0,0,0,"",0,0,0,0,0,0,0,0,0,0,0
9ade9ce1,Anis Ben Slimane,22,Sheffield Utd,Premier League,4.7,2001,MF,6,1,7,4,40.0,10,6,7,0,5,11,4,5,16,2,6
9af1f9ff,Jordan Beyer,23,Burnley,Premier League,13.7,2000,DF,7,15,22,14,58.3,24,10,68,1,16,35,1,22,51,12,20
9b066938,Kaine Kesler-Hayden,20,Aston Villa,Premier League,0.1,2002,"MF,DF",0,0,0,0,"",0,0,0,0,0,0,0,0,0,0,0
9b130479,Kirian Rodriguez,27,Las Palmas,La Liga,35.7,1996,MF,36,3,39,24,35.8,67,43,23,1,28,52,5,22,80,25,32
9b3099d6,Przemyslaw Szyminski,29,Frosinone,Serie A,0.1,1994,MF,0,1,1,0,"",0,0,0,0,0,0,0,0,0,0,0
9b398aea,Rayan Ait-Nouri,22,Wolves,Premier League,25.9,2001,"DF,MF",26,6,32,28,57.1,49,21,38,0,15,71,7,41,86,23,44
9b5237b1,Andy Diouf,20,Lens,Ligue 1,14.6,2003,MF,10,3,13,14,63.6,22,8,5,1,3,28,5,12,31,11,19
9b545925,Anthony Rouault,22,Stuttgart,Bundesliga,11.2,2001,DF,6,8,14,13,61.9,21,8,28,0,8,21,2,14,29,5,12
9b5ce51a,Jefferson Lerma,28,Crystal Palace,Premier League,26.7,1994,"MF,DF",19,12,31,19,47.5,40,21,72,0,36,42,4,15,78,23,25
9b5d89b3,Fabio Torsiello,18,Darmstadt 98,Bundesliga,1.7,2005,"FW,DF",1,0,1,1,12.5,8,7,1,0,1,1,0,1,2,0,0
9b6d9b53,Valentin Rosier,26,Nice,Ligue 1,0.6,1996,"DF,MF",1,0,1,0,"",0,0,5,0,2,1,0,1,3,0,0
9b6f7fd5,Lucas Paqueta,25,West Ham,Premier League,29.1,1997,"FW,MF",27,1,28,25,48.1,52,27,28,2,21,71,7,38,92,26,48
9ba7b4fa,Enzo Ebosse,24,Udinese,Serie A,0.1,1999,DF,0,0,0,0,0.0,1,1,0,0,1,1,0,1,2,0,1
9bc9a519,Djed Spence,22,Genoa,Serie A,9.5,2000,DF,15,5,20,8,80.0,10,2,28,0,8,16,0,12,24,4,10
9bd97418,Kevin Miranda,20,Sassuolo,Serie A,0.2,2003,DF,0,0,0,0,"",0,0,1,0,0,0,0,0,0,0,0
9c137b36,Alex Suarez,30,Las Palmas,La Liga,28.5,1993,DF,19,14,33,31,83.8,37,6,84,0,18,53,5,33,71,15,36
9c36ed83,Nicolas Jackson,22,Chelsea,Premier League,31.1,2001,FW,15,5,20,5,20.8,24,19,17,0,4,21,8,5,25,8,13
9c435456,Mario Gila,22,Lazio,Serie A,20.1,2000,DF,13,14,27,19,55.9,34,15,69,0,20,32,1,23,52,8,14
9c4f39b3,Tosin Aiyegun,25,Lorient,Ligue 1,10.0,1998,"MF,FW",3,1,4,3,33.3,9,6,8,0,2,6,1,2,8,3,4
9c94165b,Luke Shaw,28,Manchester Utd,Premier League,10.7,1995,DF,7,11,18,9,60.0,15,6,39,0,6,11,1,7,17,3,8
9cfbad36,Julio Enciso,19,Brighton,Premier League,5.3,2004,"MF,FW",11,0,11,2,28.6,7,5,3,0,0,6,1,3,6,2,2
9d33c71a,Diego Iturralde,20,Sevilla,La Liga,0.4,2003,DF,0,1,1,0,"",0,0,2,0,0,0,0,0,0,0,0
9d376bef,Medon Berisha,19,Lecce,Serie A,2.3,2003,"FW,MF",0,2,2,0,0.0,2,2,0,0,1,3,0,3,4,0,1
9d60028d,Viktor Kovalenko,27,Empoli,Serie A,6.8,1996,MF,10,2,12,2,25.0,8,6,7,0,1,5,1,2,6,2,2
9dbb75ca,Alexandre Lacazette,32,Lyon,Ligue 1,25.5,1991,FW,19,3,22,5,29.4,17,12,9,0,8,19,2,8,27,9,12
9dc96f10,Amad Diallo,21,Manchester Utd,Premier League,4.3,2002,"FW,MF",2,1,3,3,42.9,7,4,6,0,1,10,3,1,11,6,3
9dd5da03,Yoel Armougom,25,Clermont Foot,Ligue 1,2.6,1998,"DF,MF",1,0,1,2,66.7,3,1,3,0,1,3,1,2,4,0,3
9ddf7fae,Cheikh Tidiane Sabaly,24,Metz,Ligue 1,15.3,1999,"FW,MF",17,2,19,16,40.0,40,24,14,0,10,40,5,23,50,12,20
9deaf2c8,Keinan Davis,25,Udinese,Serie A,2.1,1998,"FW,MF",0,0,0,0,"",0,0,3,0,0,0,0,0,0,0,0
9e095d72,Imanol,23,Athletic Club,La Liga,5.8,2000,DF,6,0,6,5,27.8,18,13,15,0,7,7,1,1,14,5,5
9e1035f8,Ferran Torres,23,Barcelona,La Liga,13.5,2000,FW,6,1,7,5,31.3,16,11,6,0,5,9,2,1,14,6,6
9e1577aa,Cristiano Biraghi,30,Fiorentina,Serie A,26.2,1992,DF,25,5,30,28,53.8,52,24,43,0,14,47,3,20,61,24,28
9e525177,Aaron Wan-Bissaka,25,Manchester Utd,Premier League,19.8,1997,DF,14,15,29,19,73.1,26,7,68,1,41,42,4,18,83,20,25
9e7483ff,Desire Doue,18,Rennes,Ligue 1,18.1,2005,"MF,FW",29,1,30,10,30.3,33,23,8,0,14,32,7,11,46,14,18
9ef42479,Thomas Henry,28,Hellas Verona,Serie A,3.7,1994,FW,0,0,0,0,"",0,0,5,0,0,0,0,0,0,0,0
9efa1d25,Mario Gotze,31,Eint Frankfurt,Bundesliga,23.0,1992,MF,16,3,19,28,45.2,62,34,10,0,14,51,8,18,65,25,34
9f1893b9,Felipe Anderson,30,Lazio,Serie A,30.8,1993,"FW,MF",42,3,45,34,37.8,90,56,23,0,27,78,13,32,105,33,45
9f29c204,Oualid El Hajjam,32,Le Havre,Ligue 1,4.4,1991,"DF,MF",4,1,5,2,22.2,9,7,10,0,6,8,1,5,14,2,7
9f323c71,Oscar de Marcos,34,Athletic Club,La Liga,25.1,1989,DF,22,6,28,42,59.2,71,29,44,0,15,56,6,26,71,24,39
9f4a940f,Axel Camblan,19,Brest,Ligue 1,1.0,2003,FW,2,0,2,2,50.0,4,2,0,0,0,3,1,0,3,2,1
9f77012e,Tom Krauss,22,Mainz 05,Bundesliga,15.0,2001,MF,29,4,33,21,36.2,58,37,28,0,17,57,4,22,74,31,33
9f7c837d,Ben Godfrey,25,Everton,Premier League,12.4,1998,DF,6,8,14,15,53.6,28,13,57,0,16,30,5,17,46,8,20
9f84febe,Rick Karsdorp,28,Roma,Serie A,13.2,1995,DF,9,4,13,16,66.7,24,8,16,0,9,25,6,11,34,8,18
9f8e9423,Raphael Varane,30,Manchester Utd,Premier League,15.3,1993,DF,5,18,23,10,71.4,14,4,88,0,15,18,1,10,33,7,11
9f936061,Neto Borges,26,Clermont Foot,Ligue 1,28.0,1996,DF,22,6,28,28,44.4,63,35,84,0,57,48,5,25,105,18,24
9f979eb2,Jorge Mere,26,Cádiz,La Liga,7.5,1997,DF,2,3,5,4,57.1,7,3,33,0,8,8,0,6,16,2,7
9fb45456,Carlos Benavidez,25,Alavés,La Liga,12.6,1998,MF,8,5,13,19,55.9,34,15,31,0,19,56,11,19,75,26,35
a011a1e9,Owen Beck,20,Liverpool,Premier League,0.1,2002,DF,0,0,0,0,"",0,0,1,0,0,2,0,1,2,1,1
a0255c67,Manu Morlanes,24,Mallorca,La Liga,17.9,1999,MF,12,1,13,23,43.4,53,30,21,0,20,50,1,23,70,26,29
a0415710,Ismail Jakobs,23,Monaco,Ligue 1,16.3,1999,DF,17,2,19,29,61.7,47,18,40,0,11,57,9,27,68,21,41
a0666d3e,Will Hughes,28,Crystal Palace,Premier League,21.0,1995,MF,22,14,36,24,50.0,48,24,25,0,21,61,11,30,82,20,33
a08985b8,Stijn Spierings,27,Lens,Ligue 1,1.3,1996,MF,1,1,2,1,100.0,1,0,1,0,2,1,0,0,3,1,0
a08b974a,Lucas Ocampos,29,Sevilla,La Liga,31.9,1994,"FW,MF",33,1,34,29,50.0,58,29,29,0,21,66,17,22,87,27,47
a0b4bb3e,Isco,31,Betis,La Liga,25.8,1992,MF,18,1,19,14,36.8,38,24,7,0,10,41,5,15,51,21,27
a0c590b9,Emanuel Emegha,20,Strasbourg,Ligue 1,23.1,2003,FW,10,3,13,4,44.4,9,5,25,0,2,8,2,2,10,4,5
a0d55a09,Bradley Barcola,20,Paris S-G,Ligue 1,15.2,2002,"FW,MF",25,2,27,7,28.0,25,18,13,1,10,34,9,12,44,13,16
a10361d2,Aleix Garcia,26,Girona,La Liga,35.5,1997,MF,28,17,45,28,51.9,54,26,53,3,36,49,6,17,85,26,28
a105d46a,Harry Toffolo,27,"Nott'ham Forest",Premier League,16.2,1995,DF,21,13,34,15,62.5,24,9,49,0,14,26,0,20,40,6,14
a1232f4e,Eric Bailly,29,Villarreal,La Liga,9.3,1994,DF,0,8,8,2,100.0,2,0,38,2,9,5,0,4,14,1,3
a1390d2f,Carlos Baleba,19,Lille,Ligue 1,0.7,2004,MF,0,0,0,3,75.0,4,1,0,0,2,6,1,1,8,4,2
a14d0ab0,Samuele Vignato,19,Monza,Serie A,3.8,2004,"MF,FW",2,0,2,2,66.7,3,1,1,0,1,6,1,2,7,3,4
a167537f,Julian Brandt,27,Dortmund,Bundesliga,24.7,1996,"MF,FW",17,3,20,10,37.0,27,17,18,0,8,17,1,8,25,8,14
a17a94d6,Azor Matusiwa,25,Rennes,Ligue 1,8.8,1998,MF,7,2,9,4,57.1,7,3,17,0,11,7,0,3,18,4,3
a1d5bd30,Marcus Rashford,25,Manchester Utd,Premier League,25.2,1997,FW,14,1,15,9,34.6,26,17,21,0,4,19,6,9,23,4,12
a1dbb2c7,Chaim El Djebali,19,Lyon,Ligue 1,0.1,2004,MF,0,0,0,0,"",0,0,0,0,0,0,0,0,0,0,0
a254bbe0,Antonio Sanchez,26,Mallorca,La Liga,16.1,1997,MF,19,5,24,11,34.4,32,21,13,0,13,25,2,13,38,10,11
a26d3da7,Gino Caoki,19,Lorient,Ligue 1,0.1,2004,MF,0,0,0,0,0.0,1,1,0,0,0,0,0,0,0,0,0
a26fb8aa,Teun Koopmeiners,25,Atalanta,Serie A,29.2,1998,MF,30,3,33,17,34.0,50,33,35,0,10,39,5,12,49,22,24
a2852b4f,Leon Chiwome,17,Wolves,Premier League,1.9,2006,FW,2,1,3,1,50.0,2,1,2,0,0,2,1,0,2,1,1
a2a85828,Aymen Barkok,25,Mainz 05,Bundesliga,3.6,1998,"MF,FW",7,0,7,3,50.0,6,3,1,0,2,9,1,2,11,6,5
a2b105e0,Sean Longstaff,25,Newcastle Utd,Premier League,30.5,1997,MF,36,7,43,24,38.1,63,39,23,0,17,54,8,17,71,29,30
a2c9af28,Raimane Daou,18,Marseille,Ligue 1,0.3,2004,"DF,MF",0,0,0,1,50.0,2,1,2,0,0,1,0,1,1,0,1
a2d9cf74,Pascu,20,Villarreal,La Liga,0.2,2003,FW,0,0,0,0,"",0,0,0,0,0,0,0,0,0,0,0
a2d9f138,Matheus Henrique,25,Sassuolo,Serie A,27.8,1997,MF,10,8,18,18,41.9,43,25,31,6,25,43,4,21,68,18,29
a329a732,Steven Baseya,18,Strasbourg,Ligue 1,0.1,2005,DF,0,0,0,1,100.0,1,0,1,0,0,2,0,1,2,1,1
a35134ae,Aleksandar Sedlar,31,Alavés,La Liga,10.5,1991,DF,4,4,8,10,62.5,16,6,43,0,13,14,0,10,27,4,10
a36524bf,Calvin Bassey,23,Fulham,Premier League,25.6,1999,DF,21,11,32,21,72.4,29,8,84,4,28,49,1,33,77,15,29
a3695ac2,Marcin Listkowski,25,Lecce,Serie A,0.1,1998,FW,0,0,0,0,"",0,0,0,0,0,0,0,0,0,0,0
a378a02a,Ruan,24,Sassuolo,Serie A,16.8,1999,DF,3,15,18,10,55.6,18,8,68,2,24,25,4,11,49,10,15
a396fb61,Erhan Masovic,24,Bochum,Bundesliga,24.7,1998,"DF,MF",22,10,32,37,52.9,70,33,75,2,25,64,5,37,89,22,40
a3afdd69,"Mark O'Mahony",18,Brighton,Premier League,0.7,2005,FW,1,1,2,1,50.0,2,1,1,0,0,1,0,1,1,0,0
a3b03921,Joe Willock,23,Newcastle Utd,Premier League,4.7,1999,MF,7,0,7,4,36.4,11,7,1,0,1,13,0,7,14,6,7
a3c8b4d3,Loum Tchaouna,19,Salernitana,Serie A,23.3,2003,"FW,MF",19,1,20,10,50.0,20,10,16,1,4,20,2,5,24,13,10
a3d94a58,Cristian Romero,25,Tottenham,Premier League,31.0,1998,DF,24,22,46,32,72.7,44,12,106,1,44,66,6,35,110,25,40
a3ddb1b9,Mark Uth,31,Köln,Bundesliga,4.1,1991,"MF,FW",6,0,6,4,33.3,12,8,2,0,1,8,3,2,9,3,4
a40819d9,Marash Kumbulla,23,Sassuolo,Serie A,4.0,2000,DF,2,6,8,1,50.0,2,1,22,0,0,3,0,2,3,1,2
a426a912,Waren Kamanzi,22,Toulouse,Ligue 1,13.2,2000,"DF,FW",8,3,11,13,56.5,23,10,35,0,9,36,4,16,45,16,24
a44d3a3c,Pietro Pellegri,22,Torino,Serie A,8.4,2001,FW,3,1,4,1,20.0,5,4,3,0,2,5,0,1,7,4,1
a45241d5,Justin Njinmah,22,Werder Bremen,Bundesliga,11.3,2000,FW,8,1,9,3,33.3,9,6,6,0,2,5,1,2,7,2,1
a461f098,Adu Ares,21,Athletic Club,La Liga,2.9,2001,FW,1,0,1,2,66.7,3,1,0,0,1,8,2,4,9,2,4
a4948e67,"M'Bala Nzola",26,Fiorentina,Serie A,17.2,1996,FW,9,1,10,6,85.7,7,1,22,0,0,11,6,1,11,4,8
a4971d84,Djene,31,Getafe,La Liga,27.6,1991,"DF,MF",16,15,31,15,57.7,26,11,70,0,23,34,3,18,57,13,19
a4a44eb0,Montassar Talbi,25,Lorient,Ligue 1,24.5,1998,DF,16,23,39,19,59.4,32,13,114,0,32,38,2,23,70,13,22
a4ac4b8f,Willy Boly,32,"Nott'ham Forest",Premier League,16.0,1991,DF,11,21,32,22,55.0,40,18,90,0,25,46,1,36,71,9,29
a4b00319,Javi Galan,28,Real Sociedad,La Liga,11.9,1994,DF,23,1,24,15,50.0,30,15,17,1,14,38,4,15,52,19,22
a4b1028a,Hamari Traore,31,Real Sociedad,La Liga,25.5,1992,DF,19,8,27,25,58.1,43,18,59,2,24,44,3,24,68,17,19
a4e85758,Igor,25,Brighton,Premier League,18.2,1998,DF,13,9,22,17,58.6,29,12,52,1,14,25,2,7,39,16,18
a4effc55,Dan-Axel Zagadou,24,Stuttgart,Bundesliga,16.1,1999,DF,5,18,23,4,50.0,8,4,78,1,20,21,0,16,41,5,14
a5212312,Joe Worrall,26,"Nott'ham Forest",Premier League,4.9,1997,DF,1,4,5,3,50.0,6,3,32,1,3,7,0,6,10,1,5
a5296e55,Piotr Zielinski,29,Napoli,Serie A,21.4,1994,MF,11,1,12,12,50.0,24,12,15,0,9,23,4,6,32,13,15
a53649b7,Eddie Nketiah,24,Arsenal,Premier League,12.0,1999,FW,11,0,11,2,28.6,7,5,4,0,4,12,4,2,16,6,7
a53b661f,Ihlas Bebou,29,Hoffenheim,Bundesliga,18.2,1994,"FW,DF",11,2,13,8,50.0,16,8,15,0,14,22,4,10,36,8,12
a55d8df5,Aitor Ruibal,27,Betis,La Liga,11.3,1996,"DF,FW",11,1,12,32,54.2,59,27,33,1,14,46,5,28,60,13,27
a56da3ba,Juan Cruz Armada,31,Osasuna,La Liga,18.5,1992,DF,7,7,14,17,68.0,25,8,39,1,12,27,1,16,39,10,15
a572e291,Orel Mangala,25,Lyon,Ligue 1,4.4,1998,MF,1,2,3,1,33.3,3,2,6,0,5,5,3,0,10,2,3
a5ae8f8e,Milos Veljkovic,27,Werder Bremen,Bundesliga,21.3,1995,DF,11,20,31,16,51.6,31,15,57,0,17,31,1,17,48,13,15
a5db0bec,Houssem Aouar,25,Roma,Serie A,8.4,1998,"MF,FW",5,0,5,3,25.0,12,9,2,1,4,16,2,4,20,10,11
a6103274,Randy Nteka,25,Rayo Vallecano,La Liga,6.4,1997,"FW,MF",5,1,6,4,40.0,10,6,11,1,2,11,4,1,13,6,4
a6138e4a,Jessy Deminguet,25,Strasbourg,Ligue 1,7.7,1998,"MF,FW",8,0,8,6,33.3,18,12,5,1,9,14,0,6,23,8,9
a6536561,Giuliano Simeone,20,Alavés,La Liga,7.0,2002,FW,10,0,10,5,29.4,17,12,3,0,5,7,2,2,12,3,5
a65c844b,Nuno Tavares,23,"Nott'ham Forest",Premier League,5.1,2000,DF,6,0,6,8,88.9,9,1,21,0,1,11,1,9,12,1,7
a65ce836,Emre Can,29,Dortmund,Bundesliga,21.7,1994,"MF,DF",23,7,30,28,58.3,48,20,41,2,22,63,3,37,85,23,45
a681b7b7,Reece Burke,26,Luton Town,Premier League,18.4,1996,DF,7,18,25,12,46.2,26,14,78,1,18,37,6,17,55,14,23
a6951bf8,Francis Coquelin,32,Villarreal,La Liga,10.1,1991,MF,10,4,14,5,38.5,13,8,15,0,16,20,2,8,36,10,12
a6c58494,Naouirou Ahamada,21,Crystal Palace,Premier League,3.9,2002,"MF,FW",3,0,3,8,47.1,17,9,4,0,2,13,2,5,15,6,9
a712ca2b,Issa Diop,26,Fulham,Premier League,15.8,1997,DF,9,19,28,15,75.0,20,5,80,1,17,30,2,23,47,5,16
a73c8f95,Edmond Tapsoba,24,Leverkusen,Bundesliga,23.2,1999,DF,11,10,21,17,70.8,24,7,52,3,24,34,2,17,58,15,25
a755db8c,Rodrigo Muniz,22,Fulham,Premier League,17.7,2001,FW,6,3,9,1,16.7,6,5,20,0,6,7,1,1,13,5,3
a7588cdc,Antwoine Hackford,19,Sheffield Utd,Premier League,0.1,2004,FW,0,0,0,0,"",0,0,0,0,0,0,0,0,0,0,0
a758ca47,Royce Openda Owaga,21,Lorient,Ligue 1,0.2,2002,FW,0,0,0,0,"",0,0,0,0,0,0,0,0,0,0,0
a78ff07f,Joao Palhinha,28,Fulham,Premier League,30.0,1995,MF,48,9,57,103,67.8,152,49,58,0,46,152,12,80,198,60,75
a816dbfb,Danilo,22,"Nott'ham Forest",Premier League,19.9,2001,MF,25,8,33,21,45.7,46,25,42,0,35,36,2,22,71,12,18
a8567629,Mitchel Bakker,23,Atalanta,Serie A,4.2,2000,DF,5,0,5,2,16.7,12,10,6,0,3,7,0,6,10,1,3
a8748947,Tom Cairney,32,Fulham,Premier League,16.5,1991,MF,12,4,16,13,52.0,25,12,6,0,13,24,2,10,37,12,16
a8981944,Lucas Robertone,26,Almería,La Liga,26.5,1997,MF,34,9,43,25,50.0,50,25,43,0,51,61,10,28,112,23,33
a8a874f1,Manuel Locatelli,25,Juventus,Serie A,33.4,1998,MF,26,17,43,31,53.4,58,27,65,0,25,69,10,24,94,35,43
a8c0acb7,Kristoffer Ajer,25,Brentford,Premier League,20.4,1998,DF,15,11,26,23,63.9,36,13,79,1,25,38,4,25,63,9,21
a8c19eb8,Nathan Collins,22,Brentford,Premier League,29.5,2001,DF,16,30,46,19,65.5,29,10,141,4,44,38,2,24,82,12,20
a8ee54ad,Kristijan Jakic,26,Eint Frankfurt,Bundesliga,2.2,1997,"MF,FW",1,0,1,1,33.3,3,2,2,0,2,3,0,1,5,2,3
a8f21b9f,Carles Perez,25,Celta Vigo,La Liga,8.6,1998,"MF,DF",13,1,14,7,38.9,18,11,8,0,5,13,2,6,18,5,5
a9202def,Ederson,24,Atalanta,Serie A,31.9,1999,MF,40,8,48,44,69.8,63,19,33,1,41,83,7,38,124,38,49
a93b6f4e,Paul Jaeckel,25,Union Berlin,Bundesliga,2.6,1998,DF,1,2,3,5,55.6,9,4,7,0,4,7,0,4,11,3,2
a951ca82,Tiago Fonseca Morais,19,Lille,Ligue 1,0.5,2003,FW,0,0,0,0,"",0,0,0,0,1,1,0,0,2,1,1
a96103b2,Bryan Zaragoza,22,Bayern Munich,Bundesliga,2.0,2001,"FW,MF",0,0,0,3,100.0,3,0,0,0,2,4,1,2,6,1,4
a96e5dc0,Jeremy Toljan,28,Sassuolo,Serie A,23.1,1994,DF,12,5,17,9,60.0,15,6,49,1,16,13,1,8,29,4,10
a9aa0d1d,Aleksei Miranchuk,27,Atalanta,Serie A,13.1,1995,"MF,FW",5,1,6,5,38.5,13,8,5,1,2,12,2,6,14,4,6
a9aff11a,Mario Martin,19,Real Madrid,La Liga,0.2,2004,MF,1,1,2,3,75.0,4,1,0,0,0,5,3,0,5,2,1
a9b1c319,Pelly Ruddock Mpanzu,30,Luton Town,Premier League,12.2,1993,MF,8,7,15,5,55.6,9,4,16,3,9,13,1,6,22,6,5
aa25ce92,Adam Obert,20,Cagliari,Serie A,10.5,2002,DF,6,7,13,8,47.1,17,9,41,1,21,17,1,8,38,8,9
aa54ec6f,Pablo Mari,29,Monza,Serie A,29.1,1993,DF,15,25,40,22,64.7,34,12,115,1,37,41,0,34,78,7,25
aa677a35,Alex Fernandez,30,Cádiz,La Liga,14.3,1992,MF,12,5,17,11,50.0,22,11,30,0,15,19,0,10,34,9,9
aa849a12,Jack Harrison,26,Everton,Premier League,24.6,1996,"MF,FW",20,5,25,17,34.7,49,32,24,0,12,37,13,12,49,12,22
aa888da7,Omari Kellyman,17,Aston Villa,Premier League,0.4,2005,FW,0,0,0,1,50.0,2,1,0,0,0,1,0,0,1,1,0
aa8e289e,Nikola Vlasic,25,Torino,Serie A,29.0,1997,"MF,FW",19,7,26,4,13.3,30,26,16,0,11,28,8,6,39,14,16
aad48be9,Niklas Stark,28,Werder Bremen,Bundesliga,12.1,1995,DF,7,7,14,12,66.7,18,6,61,1,19,26,2,13,45,11,15
aad53e64,Kike Barja,26,Osasuna,La Liga,3.4,1997,"FW,MF",1,1,2,3,37.5,8,5,2,0,2,6,2,2,8,2,2
aad56ca3,Amine Gouiri,23,Rennes,Ligue 1,23.0,2000,"FW,MF",17,1,18,8,42.1,19,11,12,0,14,20,5,4,34,11,10
aae9d04a,Davide Faraoni,31,Fiorentina,Serie A,4.4,1991,DF,2,1,3,5,45.5,11,6,14,0,5,9,2,5,14,2,4
ab1a72b4,Julian Justvan,25,Darmstadt 98,Bundesliga,11.4,1998,"MF,FW",10,2,12,3,17.6,17,14,6,1,11,10,1,2,21,7,4
ab5b7dc1,Marius Bulter,30,Hoffenheim,Bundesliga,15.0,1993,"DF,FW",14,3,17,12,52.2,23,11,20,0,10,18,4,9,28,5,11
ab651565,Nathan Redmond,29,Burnley,Premier League,1.6,1994,"FW,MF",1,0,1,1,25.0,4,3,3,0,0,2,2,0,2,0,1
ab700320,Arne Maier,24,Augsburg,Bundesliga,11.1,1999,MF,17,2,19,5,35.7,14,9,11,0,6,14,1,5,20,8,9
ab7bf91d,Daniel Vivian,24,Athletic Club,La Liga,32.0,1999,DF,24,25,49,28,62.2,45,17,104,0,31,42,2,29,73,11,28
abd56820,Oussama Targhalline,21,Le Havre,Ligue 1,11.4,2002,MF,6,3,9,15,60.0,25,10,14,2,20,23,0,16,43,7,11
abddf25d,Ibrahim Cissoko,20,Toulouse,Ligue 1,2.7,2003,"FW,MF",3,0,3,1,33.3,3,2,0,0,1,4,0,3,5,1,3
abe66106,Erik Lamela,31,Sevilla,La Liga,5.1,1992,"FW,MF",12,0,12,10,66.7,15,5,5,0,1,21,7,4,22,10,14
abefc3af,Yassine Kechta,21,Le Havre,Ligue 1,20.5,2002,MF,17,3,20,31,42.5,73,42,16,1,23,46,3,24,69,19,24
ac05f970,Michail Antonio,33,West Ham,Premier League,18.8,1990,FW,13,3,16,3,27.3,11,8,4,0,4,15,4,5,19,6,8
ac454a4f,Gerard Gumbau,28,Granada,La Liga,29.7,1994,MF,19,5,24,23,37.1,62,39,30,2,25,55,4,21,80,30,34
ac4a4508,Gabriel Strefezza,26,Lecce,Serie A,12.4,1997,FW,17,0,17,14,70.0,20,6,11,0,7,24,9,8,31,7,17
ac73ec79,Nordi Mukiele,25,Paris S-G,Ligue 1,8.8,1997,DF,13,4,17,8,53.3,15,7,28,0,14,12,1,6,26,5,8
ac7e640b,Mattia Caldara,29,Milan,Serie A,0.4,1994,DF,0,1,1,1,100.0,1,0,1,0,1,1,0,1,2,0,1
ac7e7b1c,Facundo Pellistri,21,Granada,La Liga,13.7,2001,"MF,FW",18,0,18,6,28.6,21,15,7,0,4,29,7,12,33,10,19
ac861941,Eric Dier,29,Bayern Munich,Bundesliga,13.0,1994,DF,8,12,20,5,83.3,6,1,48,1,10,11,1,5,21,5,8
ac89503b,Gautier Lloris,28,Le Havre,Ligue 1,30.9,1995,DF,20,30,50,28,66.7,42,14,142,1,32,50,1,40,82,9,28
acf7e795,David Zima,22,Torino,Serie A,1.0,2000,DF,0,0,0,0,"",0,0,7,0,3,1,0,1,4,0,1
ad00b1a8,Benno Schmitz,28,Köln,Bundesliga,12.8,1994,DF,15,4,19,17,50.0,34,17,29,0,7,27,0,20,34,7,15
ad82197c,Axel Disasi,25,Chelsea,Premier League,28.7,1998,DF,7,19,26,23,76.7,30,7,102,2,18,33,3,20,51,10,19
add37c13,Skelly Alvero,21,Werder Bremen,Bundesliga,1.4,2002,MF,2,1,3,3,100.0,3,0,1,0,1,6,0,1,7,5,4
aded8e6f,Riccardo Calafiori,21,Bologna,Serie A,26.1,2002,DF,25,13,38,22,68.8,32,10,74,3,50,47,3,28,97,16,32
ae14af56,Joaquin Panichelli,20,Alavés,La Liga,2.5,2002,"FW,MF",1,0,1,1,50.0,2,1,4,0,1,3,1,1,4,1,3
ae44e8e2,Dani Olmo,25,RB Leipzig,Bundesliga,16.1,1998,MF,7,0,7,10,45.5,22,12,12,1,13,26,4,14,39,8,18
ae48c5cb,Ivan Martin,24,Girona,La Liga,30.3,1999,MF,22,3,25,22,38.6,57,35,14,0,21,44,7,22,65,15,25
ae4e2852,Mattia De Sciglio,30,Juventus,Serie A,0.5,1992,DF,1,0,1,0,"",0,0,2,0,1,0,0,0,1,0,0
ae4fc6a4,Eberechi Eze,25,Crystal Palace,Premier League,22.8,1998,"MF,FW",25,2,27,15,48.4,31,16,6,0,11,35,13,4,46,18,17
ae5019e6,Jayden Bogle,23,Sheffield Utd,Premier League,31.0,2000,DF,31,11,42,35,50.0,70,35,97,0,32,66,2,43,98,21,36
ae59b359,Boubakary Soumare,24,Sevilla,La Liga,25.4,1999,MF,18,7,25,14,53.8,26,12,20,1,26,39,1,24,65,14,28
ae7058f9,Julian Chabot,25,Köln,Bundesliga,30.0,1998,DF,23,43,66,35,59.3,59,24,145,0,45,59,2,40,104,17,42
ae852b7d,Alex Centelles,25,Almería,La Liga,10.9,1997,DF,3,2,5,8,44.4,18,10,29,0,18,11,0,9,29,2,6
ae94a6c5,Edoardo Bove,21,Roma,Serie A,19.8,2002,MF,20,1,21,27,58.7,46,19,11,1,11,60,13,16,71,31,31
ae961785,Florent Muslija,25,Freiburg,Bundesliga,1.2,1998,"MF,FW",1,0,1,2,40.0,5,3,2,0,0,5,0,3,5,2,4
ae9898c5,Matteo Ruggeri,21,Atalanta,Serie A,27.2,2002,DF,42,4,46,16,53.3,30,14,44,0,23,29,8,14,52,7,15
ae9a9b2d,Rachad Fettal,18,Almería,La Liga,0.2,2005,FW,0,0,0,0,"",0,0,0,0,0,1,0,1,1,0,1
ae9b998d,Brajan Gruda,19,Mainz 05,Bundesliga,18.2,2004,"MF,FW",15,0,15,14,58.3,24,10,4,0,5,22,6,5,27,11,14
aeca7743,Jackson Tchatchoua,21,Hellas Verona,Serie A,19.2,2001,DF,10,7,17,23,47.9,48,25,49,2,23,39,2,25,62,12,26
aed3a70f,Ollie Watkins,27,Aston Villa,Premier League,35.7,1995,FW,22,4,26,5,45.5,11,6,20,0,4,12,7,0,16,5,7
aeed5c06,Moussa Diaby,24,Aston Villa,Premier League,24.2,1999,"FW,MF",7,1,8,4,18.2,22,18,6,0,9,12,3,5,21,4,5
af0c835b,Samuel Moutoussamy,26,Nantes,Ligue 1,12.3,1996,MF,13,3,16,17,45.9,37,20,13,0,11,38,7,14,49,17,20
af0d79a9,Borna Sosa,25,Stuttgart,Bundesliga,0.5,1998,"FW,DF",0,0,0,0,0.0,1,1,0,0,0,0,0,0,0,0,0
af3ddb2e,Komnen Andric,28,Clermont Foot,Ligue 1,1.9,1995,FW,2,0,2,0,0.0,4,4,1,0,0,2,1,0,2,1,1
afb61630,Tijjani Reijnders,25,Milan,Serie A,31.3,1998,MF,18,8,26,21,48.8,43,22,26,0,18,46,5,10,64,31,25
afdc14d7,Nico Williams,21,Athletic Club,La Liga,25.1,2002,FW,16,2,18,13,36.1,36,23,4,1,3,31,7,9,34,15,12
afe1a491,Oliver Arblaster,19,Sheffield Utd,Premier League,10.5,2004,MF,10,7,17,7,46.7,15,8,9,0,15,23,4,11,38,8,14
afe39ca8,Theo Le Bris,20,Lorient,Ligue 1,16.8,2002,"DF,MF",21,3,24,19,47.5,40,21,42,0,12,35,3,25,47,7,22
afed6722,Valentino Livramento,20,Newcastle Utd,Premier League,14.6,2002,DF,9,7,16,10,47.6,21,11,41,1,25,23,2,15,48,6,13
b003239d,Christopher Wooh,21,Rennes,Ligue 1,15.4,2001,DF,10,9,19,8,53.3,15,7,51,0,18,18,0,12,36,6,12
b026bbf6,Lorenz Assignon,23,Rennes,Ligue 1,11.2,2000,DF,5,4,9,9,37.5,24,15,27,1,9,24,4,12,33,8,12
b05e2dbd,Jose Luis Gaya,28,Valencia,La Liga,19.9,1995,DF,15,3,18,43,64.2,67,24,42,0,11,71,4,44,82,23,36
b06a7ae9,Julien Duranville,17,Dortmund,Bundesliga,0.1,2006,"FW,MF",0,0,0,1,100.0,1,0,0,0,0,1,0,0,1,1,0
b09e0873,Zito Luvumbo,21,Cagliari,Serie A,21.6,2002,"FW,MF",19,0,19,4,26.7,15,11,2,0,1,9,2,5,10,2,6
b0b4fd3e,Jack Grealish,27,Manchester City,Premier League,11.2,1995,"FW,MF",11,2,13,6,50.0,12,6,5,0,6,13,0,6,19,7,8
b0f7e36c,Federico Chiesa,25,Juventus,Serie A,24.4,1997,FW,16,1,17,3,23.1,13,10,4,0,6,20,7,7,26,6,10
b0fce72c,Mikel Vesga,30,Athletic Club,La Liga,17.0,1993,MF,12,7,19,19,38.8,49,30,35,1,32,40,6,11,72,23,20
b116c6e3,Denis Huseinbasic,22,Köln,Bundesliga,18.1,2001,MF,25,1,26,20,64.5,31,11,14,0,13,38,6,17,51,15,18
b136c945,Hans Nicolussi Caviglia,23,Juventus,Serie A,3.0,2000,MF,4,1,5,4,66.7,6,2,2,0,0,5,1,1,5,3,2
b146275b,Victor Boniface,22,Leverkusen,Bundesliga,17.2,2000,FW,5,1,6,1,25.0,4,3,13,0,0,6,5,0,6,1,4
b151a3f2,Diego Mendez,19,Rayo Vallecano,La Liga,0.1,2003,MF,0,0,0,1,100.0,1,0,0,0,1,1,0,1,2,0,1
b19db005,Ousmane Dembele,26,Paris S-G,Ligue 1,16.7,1997,"MF,FW",11,0,11,6,46.2,13,7,4,1,5,19,10,2,24,7,14
b1b99435,Andrei Ratiu,25,Rayo Vallecano,La Liga,7.0,1998,"DF,MF",3,1,4,8,53.3,15,7,12,0,0,12,1,6,12,5,4
b1cd37e6,Filip Kostic,30,Juventus,Serie A,20.2,1992,DF,21,8,29,17,51.5,33,16,43,0,9,37,4,20,46,13,23
b1f4086c,Alex Grimaldo,27,Leverkusen,Bundesliga,30.9,1995,DF,25,7,32,30,54.5,55,25,41,0,22,45,9,26,67,10,24
b2009f99,Sadibou Sane,19,Metz,Ligue 1,9.4,2004,DF,5,9,14,6,85.7,7,1,64,0,8,19,1,16,27,2,12
b217ef29,Joel Matip,31,Liverpool,Premier League,8.7,1991,DF,4,12,16,8,66.7,12,4,43,0,9,12,1,7,21,4,6
b229aa13,Didier Lamkel Ze,26,Metz,Ligue 1,6.1,1996,"FW,MF",4,0,4,2,40.0,5,3,11,0,0,7,1,2,7,4,2
b2336681,Tiago Djalo,23,Juventus,Serie A,0.2,2000,DF,1,0,1,0,"",0,0,1,0,0,0,0,0,0,0,0
b26afd1e,Daouda Traore,17,Nice,Ligue 1,0.2,2006,MF,0,0,0,0,"",0,0,0,0,0,0,0,0,0,0,0
b28bbd58,Andros Townsend,32,Luton Town,Premier League,13.4,1991,"MF,FW",12,0,12,13,48.1,27,14,10,0,5,21,8,11,26,2,13
b2a81fc6,Mike Tresor,24,Burnley,Premier League,4.7,1999,"FW,MF",5,0,5,8,44.4,18,10,1,0,1,10,0,9,11,1,6
b2bd0f6c,Jonathan Bamba,27,Celta Vigo,La Liga,22.0,1996,"MF,FW",20,0,20,2,11.8,17,15,12,0,18,14,2,4,32,8,9
b2d31e83,Dan Burn,31,Newcastle Utd,Premier League,30.3,1992,DF,30,25,55,26,42.6,61,35,124,1,37,61,4,37,98,20,33
b2e08cb6,Nikola Sekulov,21,Juventus,Serie A,0.1,2002,FW,0,0,0,0,"",0,0,0,0,0,0,0,0,0,0,0
b2f9c73e,Carney Chukwuemeka,19,Chelsea,Premier League,2.5,2003,"MF,FW",0,1,1,1,33.3,3,2,1,0,0,6,0,3,6,3,4
b2fe86e5,Eli Junior Kroupi,17,Lorient,Ligue 1,12.0,2006,"FW,MF",6,0,6,1,11.1,9,8,5,0,10,7,3,2,17,2,4
b3325a30,Suat Serdar,26,Hellas Verona,Serie A,18.4,1997,MF,22,7,29,22,48.9,45,23,25,1,20,51,4,24,71,23,39
b34c63a5,Rayan Cherki,19,Lyon,Ligue 1,19.1,2003,"MF,FW",10,3,13,17,37.0,46,29,1,0,7,28,8,4,35,16,15
b35a7399,Leo Skiri Ostigard,23,Napoli,Serie A,18.1,1999,DF,6,12,18,6,54.5,11,5,65,0,16,24,1,13,40,10,12
b386310a,Nabil Alioui,24,Le Havre,Ligue 1,11.2,1999,"MF,FW",5,1,6,2,50.0,4,2,4,0,3,3,0,2,6,1,2
b3af9be1,Takehiro Tomiyasu,24,Arsenal,Premier League,12.8,1998,DF,6,4,10,11,61.1,18,7,33,0,18,20,1,15,38,4,9
b3b7f5a6,Timothy Chandler,33,Eint Frankfurt,Bundesliga,0.2,1990,"MF,DF",0,0,0,0,"",0,0,0,0,0,0,0,0,0,0,0
b3b9b8b8,Chadi Riad,20,Betis,La Liga,24.0,2003,DF,9,14,23,17,63.0,27,10,108,0,23,35,0,17,58,18,24
b3f8bdef,Deiver Machado,29,Lens,Ligue 1,12.5,1993,DF,11,2,13,15,75.0,20,5,8,0,7,24,4,10,31,10,18
b400bde0,Raheem Sterling,28,Chelsea,Premier League,22.0,1994,"FW,MF",13,0,13,12,46.2,26,14,9,1,13,21,6,7,34,8,10
b418dbd4,Raul Garcia,37,Athletic Club,La Liga,4.7,1986,"FW,MF",9,1,10,4,44.4,9,5,9,0,3,9,3,2,12,4,6
b4705807,Aurelio Buta,26,Eint Frankfurt,Bundesliga,19.4,1997,"DF,MF",19,5,24,21,55.3,38,17,36,0,15,40,5,19,55,16,25
b4819112,Jailson Siqueira,27,Celta Vigo,La Liga,10.0,1995,"DF,MF",8,5,13,13,54.2,24,11,32,0,12,27,0,22,39,5,18
b492126a,Tiago Tomas,21,Wolfsburg,Bundesliga,11.5,2002,"FW,MF",13,0,13,1,16.7,6,5,9,0,3,5,2,3,8,0,2
b4a014b1,Diego Carlos,30,Aston Villa,Premier League,20.2,1993,DF,5,19,24,13,61.9,21,8,78,3,13,27,1,22,40,4,16
b4b08774,Matondo-Merveille Papela,22,Mainz 05,Bundesliga,2.9,2001,"MF,DF",1,0,1,0,0.0,4,4,2,0,4,5,0,2,9,3,4
b4b4d0a6,Santiago Garcia,21,Getafe,La Liga,0.3,2001,FW,0,0,0,1,100.0,1,0,0,0,0,1,1,0,1,0,0
b4ef3fb5,Guela Doue,20,Rennes,Ligue 1,13.7,2002,DF,11,1,12,22,68.8,32,10,65,1,15,28,2,14,43,12,21
b51b1b9c,Yunus Musah,20,Milan,Serie A,16.4,2002,"MF,FW",14,4,18,8,53.3,15,7,16,1,10,25,4,15,35,6,14
b561db50,Raul Jimenez,32,Fulham,Premier League,15.5,1991,FW,8,3,11,7,35.0,20,13,13,0,4,18,6,4,22,8,12
b57e066e,Rico Lewis,18,Manchester City,Premier League,9.0,2004,"DF,MF",6,1,7,3,42.9,7,4,6,0,4,10,2,4,14,4,7
b5b9bde7,Riccardo Pagano,18,Roma,Serie A,0.6,2004,"MF,DF",1,2,3,0,0.0,6,6,2,0,0,2,0,1,2,1,2
b5bb8188,Jean Onana,23,Marseille,Ligue 1,6.3,2000,MF,8,2,10,13,52.0,25,12,11,1,11,23,3,6,34,14,14
b5e0af76,Matus Bero,27,Bochum,Bundesliga,18.5,1995,"MF,FW",21,3,24,13,40.6,32,19,26,0,12,32,7,13,44,12,22
b5f7d10b,Dodo,24,Fiorentina,Serie A,5.8,1998,DF,2,0,2,2,40.0,5,3,11,0,5,5,0,1,10,4,3
b625b241,Maghnes Akliouche,21,Monaco,Ligue 1,17.9,2002,"MF,FW",21,0,21,12,33.3,36,24,3,0,9,37,5,12,46,20,23
b62878a5,Mohammed Kudus,22,West Ham,Premier League,27.6,2000,"FW,MF",25,0,25,20,50.0,40,20,9,1,11,65,11,27,76,27,47
b63e789d,John Fleck,31,Sheffield Utd,Premier League,1.0,1991,"MF,DF",0,0,0,0,0.0,1,1,1,0,0,1,0,0,1,1,0
b66315ae,Gabriel Jesus,26,Arsenal,Premier League,16.4,1997,FW,22,1,23,5,27.8,18,13,12,0,13,24,8,11,37,5,17
b666421b,Ismael Traore,36,Metz,Ligue 1,24.7,1986,DF,13,20,33,8,38.1,21,13,86,0,30,19,0,13,49,6,12
b682dcf6,Sokratis Papastathopoulos,35,Betis,La Liga,12.6,1988,DF,6,9,15,13,76.5,17,4,60,0,6,21,0,16,27,5,14
b684a484,Jordan Pefok,27,Union Berlin,Bundesliga,0.3,1996,FW,0,1,1,0,"",0,0,0,0,0,0,0,0,0,0,0
b6964eb6,Chris Smalling,33,Roma,Serie A,4.3,1989,DF,1,5,6,1,25.0,4,3,8,0,5,1,0,1,6,0,1
b6a1cdf9,Matteo Cancellieri,21,Empoli,Serie A,19.9,2002,"FW,MF",19,0,19,13,36.1,36,23,18,0,6,35,7,12,41,16,22
b6baba31,Vivaldo Semedo,18,Udinese,Serie A,0.1,2005,FW,0,0,0,0,"",0,0,0,0,0,0,0,0,0,0,0
b6e50615,Yuri Berchiche,33,Athletic Club,La Liga,21.4,1990,DF,19,9,28,19,57.6,33,14,62,0,20,33,6,13,53,14,25
b70a4c6c,Bassirou Ndiaye,21,Lorient,Ligue 1,1.7,2002,FW,0,1,1,3,60.0,5,2,0,0,1,5,1,2,6,2,2
b70afb45,Thijs Dallinga,22,Toulouse,Ligue 1,27.9,2000,FW,7,4,11,9,60.0,15,6,35,0,3,29,12,6,32,11,15
b70bde8f,Stefano Sensi,27,Inter,Serie A,0.5,1995,MF,1,0,1,1,33.3,3,2,0,0,1,1,0,0,2,1,1
b737f944,Hannes Delcroix,24,Burnley,Premier League,6.5,1999,DF,6,3,9,3,75.0,4,1,26,0,9,10,0,6,19,4,6
b73f17f8,Evann Guessand,22,Nice,Ligue 1,17.3,2001,FW,11,1,12,6,85.7,7,1,7,0,12,16,7,2,28,7,7
b74277a0,Noussair Mazraoui,25,Bayern Munich,Bundesliga,13.3,1997,DF,13,1,14,13,61.9,21,8,27,1,20,32,7,14,52,11,21
b742cc0d,Marc Bartra,32,Betis,La Liga,2.5,1991,DF,2,1,3,4,80.0,5,1,10,0,3,4,0,3,7,1,3
b77f44a4,Marvin Friedrich,27,Gladbach,Bundesliga,17.4,1995,DF,8,20,28,12,60.0,20,8,87,0,17,23,1,16,40,6,15
b793dea2,Silvi Clua,18,Girona,La Liga,0.0,2005,MF,1,0,1,2,100.0,2,0,0,0,0,2,0,2,2,0,0
b79858d5,Albert Gudmundsson,26,Genoa,Serie A,33.5,1997,"FW,MF",13,2,15,12,27.3,44,32,13,0,11,23,5,8,34,10,10
b7aa8fd8,Paco Sanz,18,Almería,La Liga,0.3,2004,DF,0,0,0,0,0.0,1,1,4,0,0,0,0,0,0,0,0
b7ca5c51,Gabriel Paulista,32,Valencia,La Liga,15.5,1990,DF,8,7,15,6,54.5,11,5,78,0,24,10,0,8,34,2,7
b7e62e1d,Joshua Acheampong,17,Chelsea,Premier League,0.1,2006,DF,0,3,3,0,"",0,0,0,0,0,0,0,0,0,0,0
b7e92b0e,Aingeru Olabarrieta,17,Athletic Club,La Liga,0.1,2005,FW,0,0,0,0,"",0,0,0,0,0,0,0,0,0,0,0
b825a650,Kevin Kampl,32,RB Leipzig,Bundesliga,15.1,1990,MF,12,7,19,10,47.6,21,11,14,1,11,19,2,8,30,9,8
b857bd29,Antonio Raillo,31,Mallorca,La Liga,24.4,1991,DF,14,30,44,17,73.9,23,6,104,2,37,30,0,18,67,12,23
b85bf253,Martin Hongla,25,Granada,La Liga,6.2,1998,"MF,DF",3,3,6,3,33.3,9,6,13,1,6,7,0,2,13,5,3
b8a642fc,Samuel Chukwueze,24,Milan,Serie A,11.3,1999,FW,2,1,3,9,52.9,17,8,3,0,6,18,2,11,24,5,7
b8aedf06,Lucas Beraldo,19,Paris S-G,Ligue 1,11.2,2003,DF,9,6,15,10,40.0,25,15,25,0,20,22,0,14,42,8,14
b8bd60fe,Ilias Akhomach,19,Villarreal,La Liga,16.8,2004,"MF,FW",8,2,10,10,50.0,20,10,13,0,13,36,9,11,49,16,21
b8c1de25,Maxime Gonalons,34,Clermont Foot,Ligue 1,14.4,1989,MF,15,3,18,25,43.9,57,32,11,0,20,47,6,14,67,27,33
b8e17ca3,Kofi Amoako,18,Wolfsburg,Bundesliga,0.0,2005,MF,0,0,0,0,"",0,0,0,0,0,0,0,0,0,0,0
b8e740fb,Ryan Gravenberch,21,Bayern Munich,Bundesliga,0.1,2002,FW,0,0,0,0,"",0,0,0,0,0,0,0,0,0,0,0
b906757a,Aitor Paredes,23,Athletic Club,La Liga,30.0,2000,DF,12,11,23,7,50.0,14,7,104,0,33,20,0,11,53,9,11
b92b456a,Marc Cardona,28,Las Palmas,La Liga,8.0,1995,FW,5,0,5,1,8.3,12,11,7,0,2,9,2,3,11,4,8
b937e490,Ruben Vinagre,24,Hellas Verona,Serie A,3.1,1999,"DF,FW",3,3,6,3,75.0,4,1,4,0,1,4,2,1,5,1,2
b96b595c,Francesco Acerbi,35,Inter,Serie A,26.5,1988,DF,7,13,20,11,78.6,14,3,77,1,32,22,0,16,54,6,13
b99bec05,Issiaga Sylla,29,Montpellier,Ligue 1,16.2,1994,"DF,FW",14,7,21,16,47.1,34,18,53,0,23,28,2,20,51,6,17
b9ac6e0e,Denis Thomalla,30,Heidenheim,Bundesliga,5.0,1992,"MF,FW",1,2,3,5,45.5,11,6,13,0,4,9,1,4,13,4,6
b9ae8560,Niklas Schmidt,25,Toulouse,Ligue 1,14.1,1998,MF,7,7,14,16,48.5,33,17,13,0,4,36,4,13,40,19,21
b9e1436c,Harvey Elliott,20,Liverpool,Premier League,15.0,2003,"MF,FW",27,0,27,10,32.3,31,21,7,0,6,27,5,8,33,14,17
b9f282ec,Valentin Barco,19,Brighton,Premier League,3.4,2004,"DF,FW",3,0,3,6,75.0,8,2,3,1,4,11,2,4,15,5,5
ba115a40,Sebastien Haller,29,Dortmund,Bundesliga,4.4,1994,FW,3,1,4,1,100.0,1,0,7,0,0,1,0,0,1,1,0
ba1e04b3,Pedro Obiang,31,Sassuolo,Serie A,5.0,1992,MF,2,4,6,2,20.0,10,8,10,0,8,8,1,3,16,4,4
ba3d3bea,Danilo Cataldi,28,Lazio,Serie A,15.1,1994,MF,8,7,15,8,44.4,18,10,19,1,17,24,1,7,41,16,12
ba492306,Samuel Iling-Junior,19,Juventus,Serie A,9.0,2003,"DF,MF",12,5,17,11,61.1,18,7,19,0,6,23,3,9,29,11,13
ba5004e1,Damian Suarez,35,Getafe,La Liga,14.4,1988,DF,10,3,13,26,57.8,45,19,31,0,10,36,4,16,46,16,21
bac46a10,Lisandro Martinez,25,Manchester Utd,Premier League,7.2,1998,DF,2,8,10,5,41.7,12,7,26,0,5,12,0,8,17,4,8
bac89b96,Senny Mayulu,17,Paris S-G,Ligue 1,3.6,2006,"FW,MF",1,0,1,6,85.7,7,1,0,0,3,13,1,6,16,6,8
badcdcae,Denis Genreau,24,Toulouse,Ligue 1,5.2,1999,"MF,FW",7,1,8,8,53.3,15,7,8,0,6,12,0,6,18,6,9
bb08bce9,Omar Alderete,26,Getafe,La Liga,24.4,1996,DF,12,18,30,19,54.3,35,16,111,0,13,28,0,15,41,13,21
bb1cf301,Vaclav Cerny,25,Wolfsburg,Bundesliga,10.2,1997,"FW,MF",13,0,13,2,14.3,14,12,6,0,8,8,1,3,16,4,3
bb376bed,Ivan Ilic,22,Torino,Serie A,23.3,2001,MF,13,7,20,13,48.1,27,14,31,0,20,22,3,9,42,10,8
bb5fbd2b,Solly March,29,Brighton,Premier League,6.2,1994,"FW,DF",5,0,5,8,57.1,14,6,8,0,11,19,3,9,30,7,14
bba30585,Diego Llorente,29,Roma,Serie A,24.1,1993,DF,13,27,40,11,45.8,24,13,79,0,22,31,1,20,53,10,19
bbd67769,Conor Bradley,20,Liverpool,Premier League,8.4,2003,DF,16,1,17,24,63.2,38,14,14,0,10,33,7,14,43,12,25
bbd79358,Moritz Broschinski,22,Bochum,Bundesliga,13.9,2000,FW,9,2,11,2,25.0,8,6,6,0,0,11,4,2,11,5,7
bbd86530,Christopher Lenz,28,Eint Frankfurt,Bundesliga,0.1,1994,DF,0,0,0,1,100.0,1,0,1,0,0,1,0,0,1,1,1
bbf5c11b,Rafa Mir,26,Sevilla,La Liga,4.3,1997,"FW,MF",2,0,2,1,50.0,2,1,1,0,1,2,0,1,3,1,2
bc249af8,Jessic Ngankam,23,Eint Frankfurt,Bundesliga,3.1,2000,FW,0,0,0,0,"",0,0,1,0,0,3,1,1,3,1,2
bc49fd34,Jesus Santiago,19,Getafe,La Liga,7.3,2004,MF,3,0,3,4,57.1,7,3,8,0,0,17,4,8,17,5,8
bc6bd723,Alassane Plea,30,Gladbach,Bundesliga,21.3,1993,"FW,MF",11,0,11,7,46.7,15,8,6,0,2,17,4,5,19,8,7
bc7cc472,Amine Salama,23,Reims,Ligue 1,3.5,2000,FW,1,0,1,0,"",0,0,1,0,1,0,0,0,1,0,0
bc7dc64d,Bukayo Saka,21,Arsenal,Premier League,32.4,2001,FW,41,2,43,26,44.1,59,33,24,1,15,66,20,22,81,24,35
bcc81786,Kelvin Amian,25,Nantes,Ligue 1,8.9,1998,DF,6,0,6,11,73.3,15,4,28,0,7,16,0,12,23,4,7
bced0375,Ibrahim Sangare,25,"Nott'ham Forest",Premier League,11.5,1997,MF,17,7,24,12,41.4,29,17,21,0,16,42,4,25,58,13,23
bd142efb,Jonathan Tah,27,Leverkusen,Bundesliga,29.2,1996,DF,5,23,28,5,31.3,16,11,97,1,23,19,2,10,42,7,9
bd4e3824,Kamil Jozwiak,25,Granada,La Liga,6.3,1998,MF,4,0,4,9,52.9,17,8,6,0,2,13,3,4,15,6,10
bd6351cd,Joao Cancelo,29,Barcelona,La Liga,27.8,1994,DF,29,6,35,38,65.5,58,20,59,1,29,64,8,35,93,21,44
bdb624a3,Oihan Sancet,23,Athletic Club,La Liga,21.9,2000,MF,4,1,5,8,38.1,21,13,5,0,10,19,6,3,29,10,11
bdbff2b5,Martin Payero,24,Udinese,Serie A,20.0,1998,MF,18,7,25,19,41.3,46,27,21,0,15,54,7,28,69,19,32
bdc14559,Omenuke Mfulu,29,Las Palmas,La Liga,0.9,1994,"MF,FW",0,1,1,0,0.0,1,1,5,0,2,4,0,3,6,1,3
bdc74a8f,Gonzalo Villar,25,Granada,La Liga,20.0,1998,MF,22,10,32,26,63.4,41,15,26,1,6,51,5,26,57,20,33
be170419,Unai Nunez,26,Celta Vigo,La Liga,31.1,1997,DF,14,24,38,23,46.9,49,26,153,3,52,51,2,30,103,19,28
be2706c0,Mergim Vojvoda,28,Torino,Serie A,15.3,1995,DF,10,2,12,11,68.8,16,5,28,0,13,17,4,7,30,6,8
be5e1c4c,Dawid Kownacki,26,Werder Bremen,Bundesliga,4.2,1997,FW,2,1,3,1,25.0,4,3,1,0,0,1,0,1,1,0,1
be719093,Isaac Bernal,23,Sevilla,La Liga,11.5,2000,FW,12,0,12,5,55.6,9,4,11,0,0,6,2,2,6,2,3
be927d03,Ashley Young,38,Everton,Premier League,25.3,1985,"DF,MF",18,6,24,30,55.6,54,24,50,3,22,53,6,28,75,19,38
beb391dd,Maxwel Cornet,26,West Ham,Premier League,1.2,1996,"MF,FW",2,0,2,1,20.0,5,4,1,0,2,3,0,3,5,0,2
beb882a8,Maximilian Eggestein,26,Freiburg,Bundesliga,32.4,1996,MF,34,19,53,15,41.7,36,21,40,1,28,49,5,25,77,19,24
bece776f,Nabil Fekir,30,Betis,La Liga,11.7,1993,"MF,FW",9,0,9,5,50.0,10,5,3,0,7,15,3,5,22,7,10
bed68338,Abde Ezzalzouli,21,Betis,La Liga,9.6,2001,FW,10,0,10,4,28.6,14,10,5,0,5,17,5,7,22,5,14
bee704fc,Nikola Milenkovic,25,Fiorentina,Serie A,27.9,1997,DF,8,14,22,22,61.1,36,14,95,1,27,41,3,24,68,14,21
bf075f6b,Roland Sallai,26,Freiburg,Bundesliga,20.4,1997,"MF,FW",20,1,21,8,40.0,20,12,23,0,6,17,7,5,23,5,10
bf33b257,Alfie Doughty,23,Luton Town,Premier League,32.5,1999,DF,42,9,51,37,45.1,82,45,43,4,31,63,16,29,94,18,40
bf34eebd,Noni Madueke,21,Chelsea,Premier League,11.7,2002,FW,11,0,11,11,32.4,34,23,14,0,4,16,4,8,20,4,10
bf4c41f9,Arnaud Kalimuendo,21,Rennes,Ligue 1,23.8,2002,FW,11,2,13,2,40.0,5,3,4,0,4,5,1,2,9,2,4
bf57eaab,Federico Bonazzoli,26,Hellas Verona,Serie A,11.3,1997,"FW,MF",8,1,9,1,12.5,8,7,3,0,3,4,0,1,7,3,1
bf973eeb,James McConnell,18,Liverpool,Premier League,0.0,2004,MF,1,0,1,0,"",0,0,0,0,1,0,0,0,1,0,0
bfb2056e,Logan Costa,22,Toulouse,Ligue 1,29.4,2001,DF,15,27,42,15,62.5,24,9,120,1,23,40,0,31,63,9,24
bfc3b3a0,Hugo Bueno,20,Wolves,Premier League,8.2,2002,"DF,MF",13,4,17,12,63.2,19,7,24,0,6,21,2,12,27,7,14
bfd381b3,Iddrisu Baba,27,Almería,La Liga,15.9,1996,MF,14,6,20,17,43.6,39,22,27,2,11,46,1,27,57,18,26
bfdb33aa,Ismaila Sarr,25,Marseille,Ligue 1,16.1,1998,"FW,MF",15,6,21,6,35.3,17,11,11,0,13,14,2,2,27,10,8
c05dfb74,Iker Muniain,30,Athletic Club,La Liga,6.6,1992,"MF,FW",3,1,4,1,33.3,3,2,0,0,0,5,0,2,5,3,1
c05f2f8c,Danilo Soares,31,Bochum,Bundesliga,3.9,1991,DF,6,0,6,5,62.5,8,3,11,0,7,10,2,5,17,3,6
c0617e2b,Dani Ceballos,26,Real Madrid,La Liga,6.6,1996,"MF,FW",7,2,9,5,35.7,14,9,4,1,0,10,1,4,10,5,5
c066d1a5,Issa Kabore,22,Luton Town,Premier League,19.2,2001,DF,11,11,22,24,53.3,45,21,56,2,16,52,8,23,68,21,28
c0b3669f,Randal Kolo Muani,24,Eint Frankfurt,Bundesliga,1.7,1998,FW,0,0,0,0,"",0,0,1,0,0,0,0,0,0,0,0
c0c7ff58,Fabian Ruiz Pena,27,Paris S-G,Ligue 1,13.3,1996,MF,6,2,8,23,54.8,42,19,21,2,11,34,3,17,45,14,23
c13ddd3e,Matias Soule,20,Frosinone,Serie A,34.7,2003,"FW,MF",34,4,38,19,47.5,40,21,9,0,18,41,15,12,59,14,27
c149016b,Wataru Endo,30,Liverpool,Premier League,19.1,1993,MF,22,2,24,20,32.8,61,41,31,3,20,48,6,11,68,31,28
c14bc029,Saul Niguez,28,Atlético Madrid,La Liga,15.3,1994,MF,27,9,36,30,61.2,49,19,56,0,14,64,6,29,78,29,39
c1597cf7,Panos Katseris,22,Lorient,Ligue 1,11.6,2001,DF,16,4,20,16,64.0,25,9,18,0,8,26,2,16,34,8,20
c17bfb65,Joelinton,26,Newcastle Utd,Premier League,14.2,1996,"MF,FW",16,7,23,14,36.8,38,24,11,1,19,39,3,21,58,15,27
c1949191,Jarrad Branthwaite,21,Everton,Premier League,34.6,2002,DF,15,36,51,45,72.6,62,17,163,2,50,66,2,42,116,22,32
c19a2df1,Josh Wilson-Esbrand,20,Reims,Ligue 1,5.1,2002,"DF,MF",3,2,5,2,25.0,8,6,7,0,6,5,0,2,11,3,4
c1b7847c,Konrad Laimer,26,Bayern Munich,Bundesliga,19.7,1997,"DF,MF",36,6,42,22,42.3,52,30,13,2,18,56,11,25,74,20,36
c1b9b13c,Tommaso Corazza,19,Bologna,Serie A,2.2,2004,DF,2,0,2,4,44.4,9,5,3,0,5,10,0,9,15,1,4
c1ebf5d2,Abdoul Kone,18,Reims,Ligue 1,2.1,2005,DF,2,0,2,4,36.4,11,7,9,0,2,7,0,5,9,2,7
c1fe2a48,Ryan Yates,25,"Nott'ham Forest",Premier League,22.1,1997,MF,27,15,42,19,55.9,34,15,44,1,21,66,6,39,87,21,39
c1fe5f0b,Fermin Lopez,20,Barcelona,La Liga,16.1,2003,"MF,FW",13,1,14,14,35.0,40,26,9,0,4,41,8,15,45,18,21
c20892ee,Emmanuel Ekong,21,Empoli,Serie A,0.1,2002,FW,0,0,0,0,"",0,0,0,0,0,0,0,0,0,0,0
c20bdcd7,Reinildo Mandava,29,Atlético Madrid,La Liga,8.1,1994,DF,8,2,10,19,86.4,22,3,21,0,15,30,3,16,45,11,22
c2111b45,Jesus Vallejo,26,Granada,La Liga,1.2,1997,DF,1,2,3,2,100.0,2,0,1,1,0,3,0,1,3,2,1
c21983bf,Formose Mendy,22,Lorient,Ligue 1,14.0,2001,DF,11,12,23,20,60.6,33,13,59,1,20,33,1,24,53,8,19
c2211709,Ellyes Skhiri,28,Eint Frankfurt,Bundesliga,24.1,1995,MF,29,4,33,19,52.8,36,17,47,2,39,44,7,18,83,19,24
c2357b65,Emil Holm,23,Atalanta,Serie A,10.5,2000,DF,22,3,25,16,44.4,36,20,25,0,7,28,2,17,35,9,19
c235e803,Matteo Gabbia,23,Villarreal,La Liga,5.3,1999,DF,3,2,5,5,62.5,8,3,36,1,8,10,0,4,18,6,6
c23c8e0d,George Pu?ca?,27,Genoa,Serie A,2.1,1996,FW,1,0,1,0,0.0,3,3,1,0,0,0,0,0,0,0,0
c2731c10,Conor Gallagher,23,Chelsea,Premier League,34.8,2000,MF,39,11,50,33,42.9,77,44,34,0,43,85,17,37,128,31,52
c284d6fb,Becir Omeragic,21,Montpellier,Ligue 1,25.7,2002,"DF,MF",22,29,51,20,60.6,33,13,65,0,27,48,4,31,75,13,29
c2a6033c,Zakaria Aboukhlal,23,Toulouse,Ligue 1,8.4,2000,"MF,FW",8,1,9,3,25.0,12,9,2,0,1,9,3,1,10,5,8
c2bd8585,Fabian Rieder,21,Rennes,Ligue 1,4.1,2002,MF,2,1,3,6,54.5,11,5,2,0,5,13,2,2,18,9,7
c2c8897d,Alberto Moleiro,19,Las Palmas,La Liga,20.0,2003,"FW,MF",11,0,11,6,20.0,30,24,10,0,7,15,4,4,22,7,6
c3725db2,Yoann Salmier,30,Le Havre,Ligue 1,17.4,1992,DF,6,15,21,13,65.0,20,7,57,0,21,22,3,13,43,6,10
c385bf49,Sael Kumbedi,18,Lyon,Ligue 1,10.3,2005,DF,9,3,12,9,40.9,22,13,18,2,14,30,4,14,44,12,20
c38767ab,Marnon Busch,28,Heidenheim,Bundesliga,6.6,1994,DF,7,2,9,7,58.3,12,5,12,0,10,11,2,6,21,3,9
c391a179,Michael Folorunsho,25,Hellas Verona,Serie A,30.9,1998,"MF,FW",33,12,45,23,40.4,57,34,44,2,17,50,7,21,67,22,28
c393a6c4,Andrew Omobamidele,21,"Nott'ham Forest",Premier League,8.7,2002,DF,4,8,12,5,62.5,8,3,42,1,13,10,0,9,23,1,3
c3b6fa1e,Loic Nego,32,Le Havre,Ligue 1,17.3,1991,"DF,MF",10,2,12,18,60.0,30,12,17,0,16,37,4,21,53,12,26
c3e66ffe,Arnau Martinez,20,Girona,La Liga,13.8,2003,DF,10,5,15,15,46.9,32,17,41,3,10,25,2,17,35,6,16
c3ee18ef,Lucas Hernandez,27,Paris S-G,Ligue 1,21.2,1996,DF,16,5,21,29,58.0,50,21,38,0,27,52,9,28,79,15,36
c40b6180,Adam Webster,28,Brighton,Premier League,12.7,1995,DF,4,12,16,6,33.3,18,12,43,1,16,14,1,8,30,5,12
c43a8336,Kevin Keben Biakolo,19,Toulouse,Ligue 1,5.8,2004,DF,7,0,7,3,50.0,6,3,17,0,8,4,0,4,12,0,2
c4486bac,Michael Olise,21,Crystal Palace,Premier League,14.2,2001,"FW,MF",21,0,21,8,33.3,24,16,9,0,11,19,2,7,30,10,10
c455a2b2,Dejan Ljubicic,25,Köln,Bundesliga,22.8,1997,"MF,FW",20,2,22,20,46.5,43,23,11,0,18,43,5,20,61,18,27
c459a650,Joakim Maehle,26,Wolfsburg,Bundesliga,27.2,1997,"DF,MF",38,5,43,41,64.1,64,23,65,0,29,62,11,33,91,18,39
c47541e0,Bertrand Traore,27,Villarreal,La Liga,6.3,1995,MF,6,0,6,1,25.0,4,3,2,0,1,5,2,2,6,1,4
c487901c,Diego Lopez,21,Valencia,La Liga,29.5,2002,"MF,FW",22,1,23,13,23.2,56,43,12,0,20,37,7,14,57,16,25
c4987edc,Diogo Leite,24,Union Berlin,Bundesliga,30.0,1999,DF,26,22,48,25,49.0,51,26,155,1,47,52,6,31,99,15,36
c4a71372,Antonin Cartillier,19,Monaco,Ligue 1,0.1,2004,DF,1,0,1,0,"",0,0,0,0,0,0,0,0,0,0,0
c4b888df,Isaac Carcelen,30,Cádiz,La Liga,29.0,1993,DF,17,7,24,25,55.6,45,20,87,2,27,50,5,30,77,15,31
c4e87b8b,Wout Weghorst,30,Hoffenheim,Bundesliga,22.0,1992,FW,17,8,25,9,60.0,15,6,24,0,6,13,2,4,19,7,6
c4f5eb61,Urko Gonzalez,22,Real Sociedad,La Liga,1.7,2001,MF,1,0,1,2,100.0,2,0,6,0,1,4,1,0,5,3,1
c55de1f5,Nathaniel Adjei,20,Lorient,Ligue 1,13.8,2002,DF,7,8,15,6,85.7,7,1,64,1,18,13,2,8,31,3,9
c5642098,Manuel Sebastian,19,Sevilla,La Liga,1.3,2004,MF,3,0,3,3,100.0,3,0,1,0,0,4,0,4,4,0,2
c56dc39e,Rafael Toloi,32,Atalanta,Serie A,10.7,1990,DF,5,4,9,14,51.9,27,13,29,0,13,20,5,7,33,8,9
c596fcb0,Callum Wilson,31,Newcastle Utd,Premier League,11.0,1992,FW,6,0,6,0,0.0,4,4,4,0,2,5,3,0,7,2,3
c5b7c315,Michael Keane,30,Everton,Premier League,4.9,1993,DF,1,4,5,1,14.3,7,6,18,1,5,7,1,3,12,3,3
c5bdb6e3,Reiss Nelson,23,Arsenal,Premier League,3.0,1999,FW,4,1,5,8,80.0,10,2,5,0,1,9,3,5,10,1,6
c6220452,Kobbie Mainoo,18,Manchester Utd,Premier League,21.4,2005,MF,8,12,20,21,46.7,45,24,30,1,22,47,11,20,69,16,27
c678ddd7,Jeanuel Belocian,18,Rennes,Ligue 1,16.1,2005,DF,8,10,18,22,78.6,28,6,49,0,13,32,1,23,45,8,22
c68da769,Rafael Borre,27,Werder Bremen,Bundesliga,11.0,1995,FW,6,2,8,5,31.3,16,11,10,0,2,10,4,2,12,4,7
c69ef855,Alexis Blin,26,Lecce,Serie A,18.2,1996,MF,14,2,16,15,34.9,43,28,39,0,22,33,3,11,55,19,19
c6db4f29,Chukwubuikem Ikwuemesi,21,Salernitana,Serie A,11.8,2001,FW,0,1,1,2,33.3,6,4,8,0,1,3,1,0,4,2,1
c6dc9ecd,Harry Wilson,26,Fulham,Premier League,18.0,1997,FW,24,3,27,11,39.3,28,17,12,0,10,21,4,9,31,8,14
c6e8cf1f,Sasa Lukic,26,Fulham,Premier League,12.5,1996,MF,13,5,18,18,46.2,39,21,19,1,16,33,7,9,49,17,19
c6f0d5d4,Shavy Babicka,23,Toulouse,Ligue 1,4.1,2000,"FW,MF",5,1,6,2,40.0,5,3,2,0,0,11,2,2,11,7,8
c707411f,Kostas Manolas,32,Salernitana,Serie A,5.4,1991,DF,3,7,10,6,75.0,8,2,20,0,2,9,0,6,11,3,5
c7259b83,Rolando Mandragora,26,Fiorentina,Serie A,17.6,1997,MF,11,3,14,10,45.5,22,12,18,1,9,26,5,8,35,13,11
c74d63ac,Antonino Gallo,23,Lecce,Serie A,27.7,2000,DF,25,9,34,31,63.3,49,18,67,0,25,43,1,31,68,11,27
c76b7567,Adrien Thomasson,29,Lens,Ligue 1,13.3,1993,MF,14,0,14,11,32.4,34,23,10,1,9,25,5,4,34,16,14
c77a8043,Antonio Puertas,31,Granada,La Liga,8.1,1992,"MF,FW",5,0,5,6,40.0,15,9,4,0,6,12,1,6,18,5,8
c77be0cf,Pedro Pereira,25,Monza,Serie A,9.3,1998,DF,13,2,15,9,52.9,17,8,18,0,4,19,1,14,23,4,13
c78b352d,Thierry Correia,24,Valencia,La Liga,23.9,1999,DF,23,16,39,28,57.1,49,21,61,0,33,63,4,39,96,20,35
c81d773d,Tosin Adarabioyo,25,Fulham,Premier League,18.0,1997,DF,5,11,16,12,57.1,21,9,80,0,25,21,0,16,46,5,11
c83c203f,Emil Bohinen,24,Salernitana,Serie A,5.9,1999,MF,6,2,8,2,20.0,10,8,6,1,14,8,0,5,22,3,6
c84dcc88,Niccolo Pisilli,18,Roma,Serie A,0.1,2004,MF,0,0,0,0,"",0,0,0,0,0,0,0,0,0,0,0
c8aa95da,Fabian Schar,31,Newcastle Utd,Premier League,33.9,1991,DF,12,38,50,18,45.0,40,22,133,1,36,42,2,27,78,13,24
c8b3a472,Nicolai Rapp,26,Werder Bremen,Bundesliga,0.8,1996,DF,2,0,2,2,100.0,2,0,8,0,2,3,0,2,5,1,2
c8c02ac7,Mehdi Zeffane,31,Clermont Foot,Ligue 1,13.7,1992,"DF,MF",11,3,14,17,50.0,34,17,34,0,16,31,3,17,47,11,20
c8d7131c,Ridgeciano Haps,30,Genoa,Serie A,8.6,1993,DF,3,0,3,5,62.5,8,3,11,1,6,7,2,3,13,2,6
c92c24f0,Maximiliano Caufriez,26,Clermont Foot,Ligue 1,18.4,1997,DF,6,12,18,19,65.5,29,10,69,2,18,38,2,31,56,5,28
c952f633,Ulisses Garcia,27,Marseille,Ligue 1,10.1,1996,DF,5,3,8,13,65.0,20,7,13,2,7,21,2,6,28,13,16
c967f6b8,Hrvoje Smolcic,22,Eint Frankfurt,Bundesliga,3.9,2000,DF,2,1,3,4,80.0,5,1,23,1,6,7,0,7,13,0,3
c976160c,Mamadou Coulibaly,24,Salernitana,Serie A,0.0,1999,DF,0,0,0,0,"",0,0,0,0,0,0,0,0,0,0,0
c9817014,Manuel Ugarte Ribeiro,22,Paris S-G,Ligue 1,21.5,2001,MF,21,6,27,43,48.3,89,46,25,2,40,98,16,39,138,43,57
c997b942,Roberto Navarro,21,Cádiz,La Liga,21.0,2002,"MF,FW",33,0,33,22,51.2,43,21,7,1,19,46,5,20,65,21,29
c9e39d91,Brais Mendez,26,Real Sociedad,La Liga,26.8,1997,"MF,FW",19,4,23,15,34.9,43,28,21,0,12,42,9,13,54,20,28
c9fc39ce,Jan-Carlo Simic,18,Milan,Serie A,1.6,2005,DF,1,4,5,0,"",0,0,3,0,0,1,0,1,1,0,1
ca122e29,Adrien Lebeau,24,Brest,Ligue 1,0.6,1999,"MF,FW",1,1,2,0,0.0,3,3,1,0,0,0,0,0,0,0,0
ca18c8f1,Jacob Brown,25,Luton Town,Premier League,11.3,1998,"MF,FW",19,1,20,7,38.9,18,11,22,0,8,19,5,7,27,7,12
ca22ccb0,Hannibal Mejbri,20,Sevilla,La Liga,1.2,2003,MF,1,0,1,0,0.0,1,1,0,0,0,3,0,1,3,2,3
ca3db240,Gabriele Zappa,23,Cagliari,Serie A,28.5,1999,DF,24,5,29,29,70.7,41,12,75,2,20,54,9,29,74,16,31
ca607d59,Noah Okafor,23,Milan,Serie A,9.9,2000,"FW,MF",7,1,8,3,30.0,10,7,10,0,0,6,1,1,6,4,4
ca618d23,Lucas Holer,29,Freiburg,Bundesliga,25.6,1994,"FW,MF",15,4,19,4,17.4,23,19,35,0,15,32,8,14,47,10,24
ca6edaa0,Luka Romero,18,Almería,La Liga,4.9,2004,FW,11,1,12,2,50.0,4,2,2,1,1,5,0,2,6,3,1
ca76b087,Rhys Norrington-Davies,24,Sheffield Utd,Premier League,1.2,1999,DF,2,0,2,0,0.0,1,1,2,0,1,1,0,1,2,0,1
ca8033cb,Lukas Klostermann,27,RB Leipzig,Bundesliga,16.0,1996,DF,13,12,25,4,30.8,13,9,64,1,13,15,1,7,28,7,10
caa1a7f0,Michael Obafemi,23,Burnley,Premier League,0.2,2000,"FW,MF",1,0,1,0,"",0,0,0,0,0,0,0,0,0,0,0
caa7aaea,Yohann Magnin,26,Clermont Foot,Ligue 1,18.7,1997,MF,25,13,38,22,46.8,47,25,26,1,19,49,5,12,68,32,31
cab9634e,Ian Maatsen,21,Dortmund,Bundesliga,14.0,2002,DF,18,4,22,16,53.3,30,14,26,0,13,30,6,15,43,9,22
cac9e583,Jimi Tauriainen,19,Chelsea,Premier League,0.0,2004,FW,0,0,0,0,"",0,0,0,0,0,0,0,0,0,0,0
cad3fd4d,Ibrahim Salah,21,Rennes,Ligue 1,5.8,2001,"FW,MF",4,0,4,11,61.1,18,7,5,0,10,15,4,5,25,6,7
cadfa7d1,Nabil Aberdin,20,Getafe,La Liga,2.0,2002,DF,0,0,0,0,0.0,1,1,4,0,0,0,0,0,0,0,0
caec77da,Lorenzo Pirola,21,Salernitana,Serie A,22.1,2002,DF,16,30,46,15,53.6,28,13,93,1,25,39,0,25,64,14,23
cb00f1e6,Vitor Roque,18,Barcelona,La Liga,3.6,2005,FW,3,0,3,0,0.0,2,2,5,0,0,3,1,2,3,0,2
cb11b429,Patrick Wimmer,22,Wolfsburg,Bundesliga,6.5,2001,"FW,MF",14,0,14,8,44.4,18,10,7,0,3,14,4,5,17,5,5
cb1e5807,Adri Bosch,22,Granada,La Liga,0.3,2001,DF,0,0,0,0,"",0,0,1,0,0,1,0,1,1,0,1
cb641b9d,Roman Yaremchuk,27,Valencia,La Liga,10.3,1995,FW,4,0,4,3,50.0,6,3,9,0,1,5,2,1,6,2,2
cb6d81b3,Felix Agu,23,Werder Bremen,Bundesliga,17.9,1999,"DF,MF",20,7,27,29,70.7,41,12,41,0,13,45,4,28,58,13,29
cbe32194,Kingstone Mutandwa,20,Cagliari,Serie A,0.4,2003,"FW,MF",1,0,1,1,25.0,4,3,2,0,0,1,0,1,1,0,0
cc2d7ad5,Charlie Taylor,29,Burnley,Premier League,25.9,1993,DF,16,11,27,17,48.6,35,18,78,0,19,35,2,19,54,14,20
cc2dd8a5,Juan Cruz,23,Betis,La Liga,0.8,2000,FW,0,0,0,0,0.0,1,1,0,0,0,0,0,0,0,0,0
cc41f558,Matthieu Udol,27,Metz,Ligue 1,30.0,1996,DF,46,16,62,38,67.9,56,18,108,0,50,55,5,38,105,12,37
cc588cbe,Habib Keita,21,Clermont Foot,Ligue 1,14.2,2002,MF,17,10,27,17,60.7,28,11,30,0,29,34,5,14,63,15,19
cc6de655,Juanlu Sanchez,19,Sevilla,La Liga,13.1,2003,DF,17,7,24,34,58.6,58,24,36,0,12,56,4,34,68,18,35
cc704d9c,Joel Mvuka,20,Lorient,Ligue 1,2.2,2002,"DF,FW",1,0,1,3,42.9,7,4,1,0,2,5,1,3,7,1,3
cc77354e,Boubacar Kamara,23,Aston Villa,Premier League,18.4,1999,MF,14,7,21,24,51.1,47,23,16,0,21,43,6,16,64,21,29
cc7888f3,Pau Cubarsi,16,Barcelona,La Liga,17.3,2007,DF,4,16,20,13,72.2,18,5,65,0,12,22,1,18,34,3,14
cc851506,Alberto Dadie,21,Real Sociedad,La Liga,0.3,2002,MF,1,0,1,0,"",0,0,0,0,0,2,0,2,2,0,1
cc86b9a3,Leon Goretzka,28,Bayern Munich,Bundesliga,24.9,1995,MF,36,8,44,24,44.4,54,30,42,1,31,41,9,18,72,14,23
cc9256ef,Largie Ramazani,22,Almería,La Liga,17.3,2001,"FW,MF",14,2,16,6,23.1,26,20,10,0,34,12,1,5,46,6,7
cc971106,Rocco Reitz,21,Gladbach,Bundesliga,23.7,2002,MF,41,20,61,28,50.9,55,27,31,1,44,61,4,28,105,29,36
ccce7025,Sven Botman,23,Newcastle Utd,Premier League,15.3,2000,DF,4,16,20,8,61.5,13,5,61,3,9,20,0,14,29,6,13
cce181df,Geoffrey Kondogbia,30,Marseille,Ligue 1,16.3,1993,MF,17,4,21,13,40.6,32,19,25,0,30,48,5,18,78,25,31
cce9f582,Giangiacomo Magnani,27,Hellas Verona,Serie A,27.2,1995,DF,22,28,50,15,60.0,25,10,118,0,45,33,0,23,78,10,18
cd0fa27b,Hakan Calhanoglu,29,Inter,Serie A,28.4,1994,MF,16,13,29,32,65.3,49,17,22,0,24,66,8,29,90,29,33
cd1acf9d,Trent Alexander-Arnold,24,Liverpool,Premier League,23.9,1998,DF,20,2,22,27,31.0,87,60,48,5,31,39,2,26,70,11,26
cd2cb5bb,Andrej Ilic,23,Lille,Ligue 1,0.1,2000,FW,0,0,0,0,"",0,0,0,0,0,0,0,0,0,0,0
cd4b2c5f,Kaelan Casey,18,West Ham,Premier League,0.0,2004,DF,0,0,0,0,"",0,0,1,0,0,0,0,0,0,0,0
cd59a7e6,Antal Yaakobishvili,19,Girona,La Liga,0.7,2004,DF,0,0,0,1,100.0,1,0,3,0,3,2,0,1,5,1,1
cd889153,Gabriel Osho,24,Luton Town,Premier League,20.5,1998,DF,17,20,37,16,59.3,27,11,92,0,31,41,1,21,72,19,22
cdc4458b,Dion Moise Sahi,21,Strasbourg,Ligue 1,7.0,2001,"MF,FW",10,1,11,0,0.0,3,3,7,0,1,5,2,1,6,2,5
cdd70dc0,Michael Olakigbe,19,Brentford,Premier League,0.7,2004,"DF,FW",7,0,7,2,50.0,4,2,0,1,1,3,0,2,4,1,0
cddf767b,Auston Trusty,24,Sheffield Utd,Premier League,28.6,1998,DF,19,22,41,21,48.8,43,22,153,3,35,47,3,31,82,13,30
ce30bfc8,Roberto Gagliardini,29,Monza,Serie A,26.2,1994,"MF,DF",19,11,30,31,62.0,50,19,38,0,31,61,9,27,92,25,30
ce4246f5,Kurt Zouma,28,West Ham,Premier League,31.5,1994,DF,10,28,38,10,62.5,16,6,160,0,29,23,0,14,52,9,17
ce4f40c7,Cheick Doucoure,23,Crystal Palace,Premier League,10.2,2000,MF,11,2,13,18,60.0,30,12,12,0,20,34,6,15,54,13,17
ce50fd99,Jonathan David,23,Lille,Ligue 1,29.2,2000,FW,16,0,16,8,30.8,26,18,4,0,9,26,7,6,35,13,15
ce5143da,Danny Welbeck,32,Brighton,Premier League,18.8,1990,"FW,MF",12,0,12,10,58.8,17,7,17,1,9,35,9,9,44,17,17
cea59f02,Alidu Seidu,23,Clermont Foot,Ligue 1,12.6,2000,DF,8,7,15,24,77.4,31,7,37,0,25,32,0,17,57,15,24
cedc53d2,Yaya Kader Fofana,19,Reims,Ligue 1,0.4,2004,"MF,DF",0,0,0,0,0.0,1,1,0,0,1,3,1,1,4,1,3
cee88597,Ivan Balliu,31,Rayo Vallecano,La Liga,31.9,1992,DF,16,11,27,22,56.4,39,17,66,1,29,44,0,20,73,24,31
cef70c94,Jeremy Jacquet,18,Clermont Foot,Ligue 1,2.8,2005,DF,4,3,7,3,100.0,3,0,10,0,6,4,0,4,10,0,3
cf007308,Elif Elmas,23,RB Leipzig,Bundesliga,3.0,1999,"MF,FW",5,0,5,6,75.0,8,2,2,0,1,8,1,1,9,6,6
cf182add,Ismaily,33,Lille,Ligue 1,27.4,1990,DF,27,6,33,31,51.7,60,29,77,0,32,72,13,34,104,25,47
cf1ef7ec,Chrislain Matsima,21,Monaco,Ligue 1,3.3,2002,DF,3,1,4,2,28.6,7,5,4,0,4,9,1,5,13,3,7
cf603737,Max Svensson,"",Osasuna,La Liga,0.0,,FW,0,0,0,0,"",0,0,0,0,0,1,1,0,1,0,0
cf9bdd43,Siebe Van Der Heyden,25,Mallorca,La Liga,3.2,1998,DF,0,1,1,4,66.7,6,2,12,0,7,9,0,7,16,2,2
d0042ab9,Mason Holgate,26,Sheffield Utd,Premier League,7.9,1996,DF,7,5,12,5,41.7,12,7,40,0,11,12,1,5,23,6,7
d00d45ab,David Ozoh,18,Crystal Palace,Premier League,1.7,2005,"MF,DF",2,0,2,5,83.3,6,1,2,0,0,10,1,3,10,6,6
d01bbb6f,Ritsu Doan,25,Freiburg,Bundesliga,25.0,1998,"DF,MF",27,3,30,21,58.3,36,15,29,0,9,50,10,21,59,19,27
d023d70f,Karol Linetty,28,Torino,Serie A,20.6,1995,MF,16,8,24,9,31.0,29,20,27,1,23,30,1,9,53,20,21
d04b94db,Nelson Semedo,29,Wolves,Premier League,34.3,1993,"DF,MF",36,8,44,38,59.4,64,26,85,1,36,79,8,52,115,19,48
d068118b,Salim El Jebari,19,Atlético Madrid,La Liga,0.1,2004,MF,0,0,0,0,"",0,0,1,0,0,1,0,0,1,1,0
d0706b27,Marc Guehi,23,Crystal Palace,Premier League,22.5,2000,DF,5,17,22,14,58.3,24,10,89,1,18,28,0,21,46,7,19
d079becb,Alphadjo Cisse,16,Hellas Verona,Serie A,0.1,2006,FW,0,0,0,0,"",0,0,0,0,0,0,0,0,0,0,0
d07d0aeb,Patric Pfeiffer,23,Augsburg,Bundesliga,5.7,1999,DF,4,6,10,5,83.3,6,1,21,0,11,11,1,6,22,4,7
d080ed5e,Mikel Merino,27,Real Sociedad,La Liga,27.6,1996,MF,25,11,36,22,45.8,48,26,55,3,16,77,18,25,93,34,43
d0b6129f,Sander Berge,25,Burnley,Premier League,33.4,1998,MF,29,20,49,34,58.6,58,24,60,2,23,76,5,35,99,36,46
d0d8dd44,Stefan de Vrij,31,Inter,Serie A,17.6,1992,DF,12,10,22,8,53.3,15,7,51,0,24,18,1,13,42,4,13
d0ee1652,Saul Coco,24,Las Palmas,La Liga,25.5,1999,DF,12,15,27,11,61.1,18,7,120,3,20,32,0,25,52,7,19
d0f72bf1,Max Kilman,26,Wolves,Premier League,38.0,1997,DF,27,37,64,24,75.0,32,8,182,4,39,47,1,40,86,6,21
d125f22f,David Okereke,25,Torino,Serie A,2.8,1997,"FW,MF",2,0,2,0,0.0,3,3,0,0,1,3,1,1,4,1,1
d17ce930,Abdukodir Khusanov,19,Lens,Ligue 1,9.0,2004,DF,5,8,13,9,52.9,17,8,32,2,13,21,0,13,34,8,12
d19ef4ef,Alessio Zerbin,24,Napoli,Serie A,1.7,1999,"FW,DF",1,0,1,2,28.6,7,5,0,0,0,5,1,1,5,3,2
d1ac669b,Antonio Tikvic,19,Udinese,Serie A,0.0,2004,DF,0,0,0,0,"",0,0,0,0,0,0,0,0,0,0,0
d1b060e2,Abdon Prats,30,Mallorca,La Liga,14.1,1992,"FW,MF",3,3,6,3,60.0,5,2,12,0,2,6,2,2,8,2,4
d1b49282,Morten Thorsby,27,Genoa,Serie A,12.9,1996,MF,16,5,21,7,50.0,14,7,20,0,4,19,2,9,23,8,11
d2110326,Mouctar Diakhaby,26,Valencia,La Liga,11.9,1996,"DF,MF",10,7,17,11,84.6,13,2,62,0,11,18,0,9,29,9,11
d2416c2e,Yussuf Poulsen,29,RB Leipzig,Bundesliga,13.5,1994,FW,10,3,13,4,28.6,14,10,15,0,4,13,3,1,17,9,8
d2424d1b,Ben Chilwell,26,Chelsea,Premier League,8.4,1996,DF,8,3,11,5,62.5,8,3,19,1,4,15,1,5,19,9,10
d2448564,Samuel Grandsir,26,Le Havre,Ligue 1,6.7,1996,"MF,FW",4,0,4,8,44.4,18,10,3,1,3,16,2,5,19,9,12
d248cd8f,Dayot Upamecano,24,Bayern Munich,Bundesliga,19.6,1998,DF,12,7,19,15,51.7,29,14,56,3,19,34,2,21,53,11,21
d29202c2,Sory Kaba,28,Las Palmas,La Liga,8.0,1995,FW,6,0,6,0,0.0,5,5,9,0,0,2,0,0,2,2,0
d2c12fe0,Oscar Cortes,19,Lens,Ligue 1,0.5,2003,"FW,MF",1,0,1,0,"",0,0,0,0,0,0,0,0,0,0,0
d2c580ce,Yannik Keitel,23,Freiburg,Bundesliga,10.2,2000,"DF,MF",9,8,17,10,66.7,15,5,44,3,12,20,1,14,32,5,15
d2c8aacc,Xeber,26,Alavés,La Liga,3.4,1997,"FW,MF",1,1,2,3,42.9,7,4,2,0,1,5,0,3,6,2,5
d3085b49,Cauley Woodrow,28,Luton Town,Premier League,4.7,1994,"FW,MF",6,1,7,9,56.3,16,7,14,0,1,16,4,8,17,4,10
d328a254,Philip Billing,27,Bournemouth,Premier League,15.5,1996,MF,26,5,31,9,33.3,27,18,28,1,20,33,4,7,53,22,16
d37b0350,Leonardo Pavoletti,34,Cagliari,Serie A,7.0,1988,FW,1,1,2,0,0.0,1,1,7,0,0,1,1,0,1,0,1
d38fdf53,Pervis Estupinan,25,Brighton,Premier League,13.8,1998,DF,10,4,14,14,46.7,30,16,20,0,21,26,3,12,47,11,13
d3aaad90,Stephan El Shaarawy,30,Roma,Serie A,19.3,1992,"FW,DF",7,4,11,6,40.0,15,9,15,2,13,21,3,14,34,4,13
d3b54513,Aurelien Pelon,19,Lorient,Ligue 1,1.0,2004,DF,0,2,2,0,0.0,2,2,7,0,0,1,0,1,1,0,0
d3d774cc,Marc Guiu,17,Barcelona,La Liga,0.8,2006,"FW,MF",0,0,0,0,"",0,0,0,0,0,1,0,0,1,1,0
d3ddf88b,Arthur Atta,20,Metz,Ligue 1,10.3,2003,"MF,FW",10,3,13,8,42.1,19,11,23,0,10,18,3,8,28,7,14
d3de9af0,Duvan Zapata,32,Atalanta,Serie A,1.2,1991,FW,0,0,0,0,0.0,1,1,1,0,0,0,0,0,0,0,0
d4535821,Adam Marusic,30,Lazio,Serie A,34.4,1992,DF,20,7,27,27,55.1,49,22,63,2,29,45,2,24,74,19,31
d469252b,Mohamed Bamba,21,Lorient,Ligue 1,12.6,2001,FW,6,1,7,4,40.0,10,6,3,0,2,14,3,3,16,8,9
d4808594,Jon Magunacelaya,23,Real Sociedad,La Liga,1.3,2000,"FW,MF",3,0,3,4,50.0,8,4,2,0,0,5,0,2,5,3,3
d49f3e6b,Lucas Boye,27,Granada,La Liga,28.2,1996,FW,30,5,35,14,41.2,34,20,46,0,10,50,11,14,60,25,25
d4a2533d,Josip Brekalo,25,Fiorentina,Serie A,7.2,1998,FW,7,0,7,2,18.2,11,9,0,0,1,8,0,6,9,2,6
d4aa4582,Ryan One,17,Sheffield Utd,Premier League,0.1,2006,FW,0,0,0,0,"",0,0,0,0,0,0,0,0,0,0,0
d4c9725f,Theo Hernandez,25,Milan,Serie A,31.0,1997,DF,20,13,33,11,50.0,22,11,42,1,23,30,0,19,53,11,17
d4d35152,Hugo Magnetti,25,Brest,Ligue 1,26.0,1998,MF,18,1,19,24,41.4,58,34,18,0,18,49,5,18,67,26,27
d4e93bab,Daler Kuzyaev,30,Le Havre,Ligue 1,23.2,1993,MF,13,5,18,15,34.9,43,28,18,1,22,34,10,11,56,13,19
d5326924,Amin Sarr,22,Wolfsburg,Bundesliga,4.3,2001,"FW,MF",5,1,6,1,50.0,2,1,1,0,2,3,0,1,5,2,2
d557d734,Matt Doherty,31,Wolves,Premier League,12.8,1992,"DF,MF",10,5,15,12,52.2,23,11,47,0,7,31,4,17,38,10,18
d56b9520,Malo Gusto,20,Chelsea,Premier League,19.5,2003,DF,24,4,28,35,67.3,52,17,43,1,17,55,6,34,72,15,27
d595de71,Ethan Mbappe,16,Paris S-G,Ligue 1,0.5,2006,"MF,DF",1,0,1,0,0.0,2,2,0,0,0,0,0,0,0,0,0
d5d22a58,Gabriel Gudmundsson,24,Lille,Ligue 1,14.1,1999,"DF,FW",11,3,14,12,60.0,20,8,25,0,15,22,2,7,37,13,16
d5dd5f1f,Pierre-Emerick Aubameyang,34,Marseille,Ligue 1,29.1,1989,FW,25,5,30,7,26.9,26,19,26,0,9,22,7,4,31,11,14
d5f2f82b,Marquinhos,29,Paris S-G,Ligue 1,17.1,1994,DF,10,19,29,11,64.7,17,6,58,1,17,19,2,10,36,7,11
d60c03a9,Joe White,20,Newcastle Utd,Premier League,0.1,2002,MF,0,0,0,0,"",0,0,0,0,0,1,0,1,1,0,1
d61c07fd,Asaf Arania,17,Darmstadt 98,Bundesliga,0.1,2005,MF,0,0,0,0,"",0,0,0,0,0,0,0,0,0,0,0
d633fd46,Stefan Lekovic,19,Villarreal,La Liga,0.3,2004,DF,0,1,1,0,"",0,0,1,0,0,0,0,0,0,0,0
d638ab17,Papa Amadou Diallo,19,Metz,Ligue 1,9.9,2004,FW,10,1,11,7,33.3,21,14,16,0,11,18,1,10,29,7,8
d646c218,Lukas Ullrich,19,Gladbach,Bundesliga,0.5,2004,"DF,FW",0,0,0,1,25.0,4,3,1,0,0,1,0,1,1,0,0
d6e53a3a,Matthijs de Ligt,23,Bayern Munich,Bundesliga,15.4,1999,DF,4,10,14,6,54.5,11,5,52,0,19,15,3,4,34,8,12
d705ba44,Andrea Belotti,29,Roma,Serie A,7.5,1993,FW,7,0,7,3,50.0,6,3,3,0,2,8,3,2,10,3,4
d709cd5c,Mario Dominguez,19,Valencia,La Liga,0.3,2004,FW,0,0,0,0,"",0,0,0,0,0,0,0,0,0,0,0
d7547531,Naatan Skytta,21,Toulouse,Ligue 1,1.3,2002,"MF,FW",0,0,0,1,100.0,1,0,0,0,0,4,1,2,4,1,4
d7553721,Giovani Lo Celso,27,Tottenham,Premier League,5.6,1996,MF,3,1,4,9,64.3,14,5,2,0,5,22,4,10,27,8,13
d781d855,Alphonso Davies,22,Bayern Munich,Bundesliga,22.9,2000,DF,26,4,30,30,56.6,53,23,49,1,26,47,5,29,73,13,24
d7918b13,Liam Henderson,27,Empoli,Serie A,0.1,1996,MF,0,0,0,0,"",0,0,0,0,0,0,0,0,0,0,0
d7a03bf3,David Jurasek,22,Hoffenheim,Bundesliga,5.5,2000,DF,5,2,7,7,41.2,17,10,22,1,3,14,0,13,17,1,11
d7cdfd81,Tobias Kempe,34,Darmstadt 98,Bundesliga,15.0,1989,MF,12,4,16,8,33.3,24,16,12,0,9,20,3,9,29,8,13
d7d32194,Mattia Destro,32,Empoli,Serie A,4.1,1991,"FW,MF",4,0,4,1,100.0,1,0,3,0,2,2,0,0,4,2,1
d7f99582,Benson Manuel,26,Burnley,Premier League,1.3,1997,"MF,FW",1,0,1,0,"",0,0,0,0,0,3,0,2,3,1,2
d80d7f17,Inigo Arguibide,18,Osasuna,La Liga,0.2,2005,DF,0,0,0,0,"",0,0,1,0,0,1,0,0,1,1,0
d82a310a,Justin Diehl,18,Köln,Bundesliga,1.9,2004,"FW,MF",0,1,1,0,"",0,0,0,1,0,0,0,0,0,0,0
d8363914,Matteo Prati,19,Cagliari,Serie A,21.9,2003,MF,23,6,29,26,61.9,42,16,26,1,15,45,3,15,60,27,25
d85c238b,Mattia Zaccagni,28,Lazio,Serie A,21.7,1995,"FW,MF",24,2,26,9,42.9,21,12,15,0,21,27,1,11,48,15,16
d86a1f3e,Tyler Onyango,20,Everton,Premier League,0.0,2003,MF,0,0,0,0,"",0,0,0,0,0,0,0,0,0,0,0
d8712bf9,Bebe,33,Rayo Vallecano,La Liga,2.4,1990,"MF,FW",1,0,1,1,20.0,5,4,0,0,0,2,0,1,2,1,2
d87e2cae,Willian Jose,31,Betis,La Liga,21.9,1991,FW,6,2,8,2,40.0,5,3,15,0,2,7,4,1,9,2,3
d8931174,Harry Maguire,30,Manchester Utd,Premier League,18.4,1993,DF,9,24,33,12,54.5,22,10,83,1,25,24,0,14,49,10,17
d8c19a60,Ibrahim Diakite,19,Reims,Ligue 1,1.2,2003,DF,3,0,3,0,0.0,1,1,5,0,2,1,0,0,3,1,0
d8cda243,Kenan Yildiz,18,Juventus,Serie A,10.6,2005,"FW,MF",6,0,6,4,50.0,8,4,4,0,1,13,2,5,14,6,9
d91f104d,Alfie Gilchrist,19,Chelsea,Premier League,2.3,2003,DF,3,3,6,2,40.0,5,3,11,0,3,4,0,4,7,0,0
d925b04e,Moussa Diakite,19,Cádiz,La Liga,0.0,2003,MF,0,0,0,0,"",0,0,0,0,0,0,0,0,0,0,0
d93c2511,Scott McTominay,26,Manchester Utd,Premier League,21.1,1996,"MF,FW",22,12,34,22,66.7,33,11,54,0,14,49,2,23,63,24,25
d9565625,Diogo Dalot,24,Manchester Utd,Premier League,35.3,1999,DF,28,16,44,51,68.9,74,23,111,0,37,81,11,58,118,12,51
d9764034,Guillermo Maripan,29,Monaco,Ligue 1,19.6,1994,DF,13,13,26,10,37.0,27,17,106,4,30,22,1,15,52,6,8
d97af612,Keito Nakamura,23,Reims,Ligue 1,15.3,2000,"FW,MF",13,2,15,17,45.9,37,20,7,0,6,28,9,9,34,10,11
d995ed27,Giacomo Bonaventura,33,Fiorentina,Serie A,25.3,1989,MF,15,1,16,9,42.9,21,12,10,0,14,26,10,6,40,10,13
d9ba39fc,Diego Rico,30,Getafe,La Liga,28.2,1993,DF,17,8,25,41,53.9,76,35,76,0,41,64,9,32,105,23,48
d9e7c4da,Joseph Johnson,17,Luton Town,Premier League,0.9,2006,DF,0,0,0,0,0.0,1,1,0,0,0,0,0,0,0,0,0
d9ebed1c,Filippo Ranocchia,22,Empoli,Serie A,5.3,2001,"MF,DF",8,1,9,7,43.8,16,9,14,0,3,16,0,7,19,9,11
d9f83409,Giacomo Corona,19,Empoli,Serie A,0.1,2004,FW,0,0,0,0,"",0,0,0,0,0,0,0,0,0,0,0
da011f18,Lewis Hall,18,Newcastle Utd,Premier League,8.7,2004,DF,15,2,17,17,60.7,28,11,22,1,12,28,1,17,40,10,18
da052c14,Jordan Ayew,31,Crystal Palace,Premier League,28.3,1991,"FW,MF",41,2,43,21,50.0,42,21,15,0,16,65,14,23,81,28,36
da27e268,Marc Roca,26,Betis,La Liga,22.0,1996,MF,23,6,29,30,56.6,53,23,23,1,17,52,6,17,69,29,36
da4d670f,Xavi Simons,20,RB Leipzig,Bundesliga,29.5,2003,MF,23,0,23,15,48.4,31,16,4,0,16,30,9,10,46,11,17
da69a0ef,Andrea Ferraris,20,Monza,Serie A,0.1,2003,MF,0,0,0,0,"",0,0,0,0,0,1,0,1,1,0,1
da76bab4,Valentin Castellanos,24,Lazio,Serie A,18.7,1998,FW,20,2,22,6,30.0,20,14,18,0,2,22,9,1,24,12,10
da7b447d,Davinson Sanchez,27,Tottenham,Premier League,0.9,1996,DF,1,2,3,0,"",0,0,2,0,1,0,0,0,1,0,0
da82ccb1,Pablo Busto,17,Betis,La Liga,0.5,2005,DF,0,0,0,1,100.0,1,0,3,0,1,1,1,0,2,0,1
daa11a4f,Andy Logbo,19,Le Havre,Ligue 1,2.8,2004,FW,4,3,7,0,0.0,3,3,2,0,0,0,0,0,0,0,0
daa2eab3,Carlos Dotor,22,Celta Vigo,La Liga,7.9,2001,MF,10,2,12,4,30.8,13,9,4,0,4,14,3,3,18,8,7
dab84ad2,Mason Burstow,19,Chelsea,Premier League,0.1,2003,FW,0,0,0,0,"",0,0,0,0,0,0,0,0,0,0,0
dac2bed8,Leonardo Mendicino,17,Atalanta,Serie A,0.0,2006,MF,0,0,0,0,"",0,0,0,0,0,0,0,0,0,0,0
dacf856a,Mamadou Coulibaly,19,Monaco,Ligue 1,1.3,2004,MF,4,0,4,3,37.5,8,5,0,0,0,7,2,2,7,3,4
dad4b285,Joel Veltman,31,Brighton,Premier League,17.6,1992,DF,10,7,17,39,67.2,58,19,57,1,18,54,5,32,72,17,41
db001fa9,Alfonso Espino,31,Rayo Vallecano,La Liga,27.9,1992,DF,22,4,26,30,36.6,82,52,63,0,40,67,2,43,107,22,45
db092d3b,Ismael Bennacer,25,Milan,Serie A,12.8,1997,MF,8,4,12,11,50.0,22,11,9,2,12,29,2,11,41,16,19
db4ed67b,Mahmoud Dahoud,27,Stuttgart,Bundesliga,2.5,1996,MF,4,0,4,3,42.9,7,4,1,0,0,5,0,1,5,4,1
db714daf,Benito Ramirez,28,Las Palmas,La Liga,4.3,1995,"FW,MF",6,1,7,3,50.0,6,3,0,0,3,5,0,2,8,3,3
db7849ca,Franck Honorat,26,Gladbach,Bundesliga,26.1,1996,"DF,FW",19,3,22,11,55.0,20,9,35,1,9,25,2,13,34,10,13
db8f0eba,Adri Embarba,31,Almería,La Liga,27.5,1992,"FW,MF",36,1,37,26,49.1,53,27,12,0,15,55,11,29,70,15,37
dbd3a428,Junya Ito,30,Reims,Ligue 1,30.2,1993,"FW,MF",22,1,23,10,27.8,36,26,7,0,14,33,8,11,47,14,15
dbf053da,Jadon Sancho,23,Dortmund,Bundesliga,10.5,2000,"FW,MF",11,0,11,0,0.0,4,4,6,0,4,5,1,1,9,3,4
dbfa4f16,Festy Ebosele,20,Udinese,Serie A,18.9,2002,DF,31,2,33,21,60.0,35,14,27,0,10,33,1,23,43,9,20
dc1c2fce,Alex Berenguer,28,Athletic Club,La Liga,17.7,1995,FW,23,0,23,7,29.2,24,17,13,0,5,23,5,9,28,9,14
dc1ce4f5,Cristhian Mosquera,19,Valencia,La Liga,34.2,2004,DF,19,23,42,25,64.1,39,14,137,2,36,57,3,36,93,18,34
dc3e663e,Jakub Kiwior,23,Arsenal,Premier League,10.5,2000,DF,8,3,11,14,73.7,19,5,28,1,8,20,1,11,28,8,12
dc3fa3b5,Diego Demme,31,Napoli,Serie A,0.8,1991,MF,0,0,0,0,0.0,1,1,0,0,0,1,0,0,1,1,1
dc44b03c,Samuel Omorodion,19,Granada,La Liga,0.9,2004,FW,0,0,0,1,100.0,1,0,0,0,0,1,0,0,1,1,1
dc4cae05,David Brooks,26,Bournemouth,Premier League,3.1,1997,"FW,MF",3,0,3,2,50.0,4,2,2,0,2,5,2,2,7,1,4
dc5ea86b,Eneko Ortiz,20,Alavés,La Liga,0.2,2003,DF,0,0,0,0,"",0,0,0,0,0,0,0,0,0,0,0
dc61b402,Luca Mazzitelli,27,Frosinone,Serie A,24.6,1995,MF,16,7,23,26,53.1,49,23,62,0,19,45,6,15,64,24,23
dc62b55d,Matheus Cunha,24,Wolves,Premier League,27.1,1999,"FW,MF",21,7,28,13,37.1,35,22,21,1,13,30,5,8,43,17,16
dc62fbee,Leonardo Bittencourt,29,Werder Bremen,Bundesliga,17.5,1993,MF,17,1,18,15,38.5,39,24,6,0,13,42,5,20,55,17,18
dc6f5bdd,Calum Chambers,28,Aston Villa,Premier League,1.7,1995,"MF,DF",1,1,2,0,0.0,1,1,4,0,2,3,0,3,5,0,0
dc7a172e,Jon Aramburu,21,Real Sociedad,La Liga,6.0,2002,DF,5,3,8,15,60.0,25,10,17,0,7,24,2,12,31,10,15
dc7f8a28,Cole Palmer,21,Manchester City,Premier League,0.1,2002,MF,0,0,0,0,"",0,0,0,0,0,0,0,0,0,0,0
dcd94cdb,Bastien Meupiyou,17,Nantes,Ligue 1,0.1,2006,DF,0,0,0,0,"",0,0,1,0,0,0,0,0,0,0,0
dcfb17f4,Amine Adli,23,Leverkusen,Bundesliga,10.0,2000,"MF,FW",8,2,10,7,41.2,17,10,5,0,6,16,4,2,22,10,7
dd0daf32,Henrikh Mkhitaryan,34,Inter,Serie A,30.9,1989,MF,19,4,23,24,49.0,49,25,43,0,29,62,9,18,91,35,34
dd211559,Gedeon Kalulu,25,Lorient,Ligue 1,10.8,1997,DF,16,2,18,12,54.5,22,10,30,0,5,23,2,13,28,8,17
dd2e62da,Finn Ole Becker,23,Hoffenheim,Bundesliga,6.7,2000,MF,8,1,9,4,23.5,17,13,10,0,1,10,0,8,11,2,9
dd323728,Neco Williams,22,"Nott'ham Forest",Premier League,18.2,2001,DF,31,13,44,35,62.5,56,21,53,0,22,69,9,42,91,18,40
dd403465,Pablo Galdames Millan,26,Genoa,Serie A,0.1,1996,"MF,DF",1,0,1,0,"",0,0,0,0,0,0,0,0,0,0,0
dd549382,Deniz Undav,27,Stuttgart,Bundesliga,23.2,1996,"FW,MF",17,0,17,4,26.7,15,11,5,0,6,28,14,6,34,8,13
dd676a97,Noah Weisshaupt,21,Freiburg,Bundesliga,8.4,2001,"DF,FW",7,1,8,5,45.5,11,6,12,0,8,9,3,6,17,0,4
dd745366,Andrey Santos,19,Strasbourg,Ligue 1,9.2,2004,MF,8,0,8,17,65.4,26,9,11,1,10,29,1,15,39,13,18
dd86e8e4,Liberato Cacace,22,Empoli,Serie A,21.2,2000,DF,17,6,23,24,63.2,38,14,56,0,19,40,3,24,59,13,24
dd9caa07,Patrick Mainka,28,Heidenheim,Bundesliga,34.0,1994,DF,34,32,66,38,51.4,74,36,158,1,49,85,3,58,134,24,49
de0abf23,Zack Nelson,18,Luton Town,Premier League,0.1,2004,"MF,DF",0,0,0,0,"",0,0,0,0,0,1,0,1,1,0,0
de0f152c,Adam Masina,29,Torino,Serie A,11.4,1994,DF,6,6,12,5,25.0,20,15,30,0,11,17,1,8,28,8,12
de112b84,Jacob Murphy,28,Newcastle Utd,Premier League,13.2,1995,"FW,DF",17,0,17,12,46.2,26,14,16,0,6,20,8,8,26,4,10
de13cee5,Sam Beukema,24,Bologna,Serie A,28.3,1998,DF,14,21,35,16,64.0,25,9,99,2,15,27,2,14,42,11,11
de17db90,Gift Orban,21,Lyon,Ligue 1,5.3,2002,FW,2,0,2,1,25.0,4,3,2,1,1,4,3,0,5,1,3
de31038e,Elliot Anderson,20,Newcastle Utd,Premier League,11.4,2002,"MF,FW",19,4,23,15,51.7,29,14,23,0,8,24,3,12,32,9,18
de39485a,Yannick Carrasco,29,Atlético Madrid,La Liga,2.5,1993,DF,2,0,2,2,28.6,7,5,6,0,1,4,0,3,5,1,4
de4cac2d,Silas Katompa,24,Stuttgart,Bundesliga,10.0,1998,"FW,MF",9,0,9,3,25.0,12,9,4,0,0,5,0,3,5,2,3
de5b5570,Marvelous Nakamba,29,Luton Town,Premier League,12.6,1994,MF,17,6,23,24,57.1,42,18,11,1,11,40,2,24,51,14,24
de838f86,Anthony Jung,31,Werder Bremen,Bundesliga,28.7,1991,DF,22,17,39,18,54.5,33,15,102,0,24,37,2,21,61,14,23
dea88efd,Khvicha Kvaratskhelia,22,Napoli,Serie A,30.4,2001,FW,14,1,15,15,30.6,49,34,9,0,13,42,12,11,55,19,21
debe38a0,John Egan,30,Sheffield Utd,Premier League,5.4,1992,DF,6,4,10,4,36.4,11,7,39,1,13,6,0,4,19,2,4
dee86451,William Carvalho,31,Betis,La Liga,7.6,1992,MF,7,1,8,10,62.5,16,6,9,1,8,20,2,11,28,7,12
df0a4c90,Christian Norgaard,29,Brentford,Premier League,27.8,1994,MF,42,6,48,32,36.8,87,55,50,0,54,81,8,42,135,31,50
df10e27c,Billy Gilmour,22,Brighton,Premier League,23.6,2001,MF,14,9,23,11,31.4,35,24,14,1,11,26,2,14,37,10,16
df1665d7,Luca Raimund,18,Stuttgart,Bundesliga,0.3,2005,"FW,MF",2,0,2,0,"",0,0,0,0,0,3,0,2,3,1,1
df33ecb5,Jon Martin,17,Real Sociedad,La Liga,0.3,2006,DF,0,0,0,0,"",0,0,3,0,0,0,0,0,0,0,0
df3cda47,Dejan Kulusevski,23,Tottenham,Premier League,30.7,2000,"FW,MF",23,1,24,25,37.3,67,42,2,1,18,62,23,19,80,20,33
df69b544,Antoine Griezmann,32,Atlético Madrid,La Liga,29.4,1991,"FW,MF",31,3,34,15,36.6,41,26,23,1,10,33,5,14,43,14,19
df8b52a5,Emerson,24,Tottenham,Premier League,12.9,1999,DF,13,10,23,21,48.8,43,22,50,1,20,36,3,23,56,10,24
df8d6029,Arthur Theate,23,Rennes,Ligue 1,25.5,2000,DF,17,23,40,24,64.9,37,13,90,2,31,30,5,19,61,6,17
dfb6490a,Patrick Herrmann,32,Gladbach,Bundesliga,1.0,1991,"FW,DF",1,0,1,2,100.0,2,0,2,0,1,4,1,2,5,1,4
dfc5d4fa,Soungoutou Magassa,19,Monaco,Ligue 1,15.0,2003,"DF,MF",17,4,21,26,54.2,48,22,36,2,21,56,2,22,77,32,26
dfd24c07,Jaime Baez,28,Frosinone,Serie A,5.6,1995,"FW,MF",5,0,5,0,0.0,7,7,1,0,4,4,2,0,8,2,1
dfd56738,Marco Brescianini,23,Frosinone,Serie A,25.8,2000,MF,17,5,22,9,36.0,25,16,37,0,10,28,3,13,38,12,13
dff153a4,Leandro Paredes,29,Roma,Serie A,29.3,1994,MF,19,7,26,33,42.9,77,44,43,1,29,57,5,30,86,22,36
e04dca4a,Axel Guessand,18,Udinese,Serie A,0.5,2004,DF,1,0,1,1,100.0,1,0,0,0,0,1,0,0,1,1,1
e06683ca,Virgil van Dijk,32,Liverpool,Premier League,35.3,1991,DF,13,34,47,12,85.7,14,2,144,0,39,40,3,24,79,13,23
e08647d6,Carlos Fernandez,27,Real Sociedad,La Liga,4.5,1996,FW,4,0,4,0,0.0,2,2,5,0,0,11,2,3,11,6,7
e08ac719,Lautaro Gianetti,29,Udinese,Serie A,7.0,1993,DF,4,6,10,4,80.0,5,1,39,0,19,9,0,7,28,2,4
e0921a4f,Paulo Dybala,29,Roma,Serie A,21.8,1993,"FW,MF",12,0,12,2,11.1,18,16,6,1,3,22,9,3,25,10,13
e09f279b,Ivan Toney,27,Brentford,Premier League,16.1,1996,FW,4,1,5,6,42.9,14,8,18,0,10,15,6,2,25,7,5
e0b113a7,Robert Andrich,28,Leverkusen,Bundesliga,18.8,1994,"MF,DF",11,4,15,13,54.2,24,11,17,0,20,30,8,8,50,14,18
e0bc6fdc,Emerson Palmieri,28,West Ham,Premier League,34.9,1994,DF,32,15,47,57,63.3,90,33,96,0,43,106,16,48,149,42,68
e0ce7038,Alessandro Di Pardo,24,Cagliari,Serie A,4.0,1999,"DF,MF",7,2,9,0,0.0,3,3,7,0,5,4,1,3,9,0,1
e0f3a1f6,Jean-Charles Castelletto,28,Nantes,Ligue 1,27.4,1995,DF,9,10,19,18,62.1,29,11,81,0,32,34,2,22,66,10,26
e0f8151c,Kim Min-jae,26,Bayern Munich,Bundesliga,21.9,1996,DF,10,19,29,12,50.0,24,12,70,2,45,37,5,21,82,11,24
e110ea4b,"Nathan N'Goumou",23,Gladbach,Bundesliga,15.4,2000,"FW,MF",22,0,22,16,47.1,34,18,17,1,5,37,2,17,42,18,22
e12b0b5b,Sebastian Rode,32,Eint Frankfurt,Bundesliga,0.7,1990,MF,0,0,0,4,66.7,6,2,1,0,1,6,1,0,7,5,4
e14ec482,Riccardo Orsolini,26,Bologna,Serie A,19.9,1997,"FW,MF",22,3,25,9,30.0,30,21,19,1,8,23,6,13,31,4,14
e1618c22,Aaron Ramsey,20,Burnley,Premier League,5.9,2003,"MF,FW",9,2,11,8,50.0,16,8,10,0,1,17,5,7,18,5,14
e162b013,Thomas Meunier,31,Dortmund,Bundesliga,6.5,1991,DF,6,2,8,3,23.1,13,10,22,0,4,5,0,3,9,2,1
e19660a8,Michael Kayode,19,Fiorentina,Serie A,22.9,2004,DF,13,12,25,35,72.9,48,13,46,2,18,53,11,27,71,15,30
e19bc88c,Christos Papadopoulos,18,Genoa,Serie A,0.0,2004,FW,0,0,0,0,0.0,1,1,0,0,0,0,0,0,0,0,0
e19c989c,Jorge Herrando,22,Osasuna,La Liga,18.3,2001,DF,9,11,20,12,63.2,19,7,69,1,15,29,0,23,44,6,19
e1cbb531,Stanislav Lobotka,28,Napoli,Serie A,36.5,1994,MF,22,8,30,24,40.0,60,36,29,0,30,61,13,18,91,30,39
e1df6989,Imran Louza,24,Lorient,Ligue 1,9.6,1999,MF,7,1,8,2,25.0,8,6,4,0,9,13,3,2,22,8,7
e27da244,John Brooks,30,Hoffenheim,Bundesliga,17.1,1993,DF,12,17,29,15,50.0,30,15,109,1,27,28,1,17,55,10,15
e27fdbca,Wilson Manafa,29,Granada,La Liga,2.7,1994,"DF,MF",1,0,1,4,57.1,7,3,4,1,1,6,1,3,7,2,4
e280527c,Marcel Sabitzer,29,Dortmund,Bundesliga,21.8,1994,MF,19,12,31,23,54.8,42,19,34,0,12,39,1,18,51,20,24
e28868f3,Jonny Castro,29,Wolves,Premier League,0.1,1994,MF,0,1,1,0,0.0,1,1,0,0,0,0,0,0,0,0,0
e288d4b3,Alessandro Florenzi,32,Milan,Serie A,19.2,1991,DF,7,9,16,26,54.2,48,22,25,1,20,43,5,26,63,12,21
e2ae54db,Hakon Arnar Haraldsson,20,Lille,Ligue 1,14.3,2003,"FW,MF",5,2,7,5,23.8,21,16,5,0,3,12,1,4,15,7,8
e31708b2,Amadou Diallo,20,Newcastle Utd,Premier League,0.0,2003,MF,0,0,0,0,"",0,0,0,0,0,0,0,0,0,0,0
e33c06cf,Niklas Sule,27,Dortmund,Bundesliga,16.8,1995,DF,11,14,25,11,68.8,16,5,58,2,25,18,1,14,43,3,10
e33fb79d,Shamar Nicholson,26,Clermont Foot,Ligue 1,16.5,1997,FW,4,2,6,1,25.0,4,3,15,0,0,6,2,0,6,4,2
e342ad68,Mohamed Salah,31,Liverpool,Premier League,28.2,1992,FW,18,1,19,6,28.6,21,15,1,0,2,17,8,1,19,8,11
e34e086c,Jovane Cabral,25,Salernitana,Serie A,7.5,1998,"MF,FW",3,0,3,3,33.3,9,6,4,0,1,13,2,4,14,7,9
e34fc66d,Joachim Andersen,27,Crystal Palace,Premier League,37.9,1996,DF,15,18,33,29,74.4,39,10,207,1,41,56,2,33,97,21,35
e3756e72,Raoul Bellanova,23,Torino,Serie A,33.8,2000,DF,17,4,21,18,58.1,31,13,36,3,15,36,4,15,51,17,26
e3a5814e,Ainsley Maitland-Niles,25,Lyon,Ligue 1,15.9,1997,"DF,MF",10,6,16,19,51.4,37,18,29,1,17,34,8,12,51,14,18
e3e32fbb,Igor Carioca,26,Lorient,Ligue 1,2.9,1996,"DF,MF",0,0,0,4,66.7,6,2,6,0,3,8,1,6,11,1,6
e4238fb1,Jaidon Anthony,23,Bournemouth,Premier League,1.7,1999,FW,3,0,3,1,14.3,7,6,3,0,1,3,2,1,4,0,1
e42d61c7,Achraf Hakimi,24,Paris S-G,Ligue 1,21.5,1998,DF,24,4,28,17,50.0,34,17,28,2,12,29,6,14,41,9,19
e43a4083,Ignacio Miramon,20,Lille,Ligue 1,0.4,2003,MF,1,0,1,0,0.0,1,1,0,0,0,1,0,0,1,1,0
e4448c8c,Sacha Delaye,21,Montpellier,Ligue 1,1.4,2002,"MF,FW",2,0,2,1,16.7,6,5,1,0,0,7,3,2,7,2,2
e447352c,Famara Diedhiou,30,Granada,La Liga,1.0,1992,"FW,MF",0,0,0,0,0.0,1,1,2,0,0,1,0,0,1,1,1
e46012d4,Kevin De Bruyne,32,Manchester City,Premier League,13.6,1991,MF,5,0,5,7,35.0,20,13,4,0,4,14,8,1,18,5,9
e4ba67f2,Giorgio Cittadini,21,Genoa,Serie A,1.2,2002,DF,1,0,1,3,100.0,3,0,5,0,3,5,0,4,8,1,4
e50623a0,"Kevin N'Doram",27,Metz,Ligue 1,17.8,1996,MF,9,8,17,17,44.7,38,21,38,0,27,31,2,20,58,9,22
e514ab62,Matt Targett,27,Newcastle Utd,Premier League,0.9,1995,DF,1,0,1,1,100.0,1,0,2,0,0,2,0,1,2,1,0
e541326e,Ethan Pinnock,30,Brentford,Premier League,28.0,1993,DF,16,24,40,9,45.0,20,11,170,3,43,35,0,22,78,13,23
e546b2e3,Julien Ponceau,22,Lorient,Ligue 1,24.9,2000,MF,21,1,22,9,30.0,30,21,20,0,19,32,6,12,51,14,15
e5478b87,Taiwo Awoniyi,25,"Nott'ham Forest",Premier League,11.6,1997,FW,5,2,7,1,50.0,2,1,9,0,1,9,4,1,10,4,7
e547d3cf,Umut Tohumcu,18,Hoffenheim,Bundesliga,11.2,2004,MF,10,1,11,6,31.6,19,13,12,0,6,16,0,9,22,7,12
e54a9890,Faitout Maouassa,25,Lens,Ligue 1,0.8,1998,"MF,DF",1,0,1,1,100.0,1,0,3,0,0,1,0,1,1,0,1
e5649a78,Kevin Stoger,29,Bochum,Bundesliga,29.6,1993,MF,42,4,46,25,39.7,63,38,18,0,19,49,7,21,68,21,30
e58cbfd5,Nicolo Rovella,21,Lazio,Serie A,14.6,2001,MF,21,6,27,16,44.4,36,20,29,0,23,46,4,25,69,17,28
e599253a,Mario Pasalic,28,Atalanta,Serie A,22.8,1995,MF,23,6,29,14,45.2,31,17,34,0,16,28,1,9,44,18,17
e5a35ae9,Luca Waldschmidt,27,Köln,Bundesliga,12.7,1996,"MF,FW",15,3,18,5,31.3,16,11,8,1,6,19,3,4,25,12,12
e5d01ecf,Kiko Femenia,32,Villarreal,La Liga,17.6,1991,DF,15,6,21,19,55.9,34,15,45,0,31,35,3,19,66,13,25
e5d85da8,Linton Maina,24,Köln,Bundesliga,21.1,1999,"FW,MF",11,1,12,9,32.1,28,19,12,0,6,18,2,11,24,5,15
e5ec95f8,Mamadou Sylla,29,Alavés,La Liga,0.2,1994,"FW,MF",0,1,1,0,"",0,0,1,0,0,0,0,0,0,0,0
e5f76710,Benedikt Gimber,26,Heidenheim,Bundesliga,22.5,1997,DF,10,17,27,19,54.3,35,16,101,1,16,40,1,25,56,14,24
e606b6c0,Adama Bojang,19,Reims,Ligue 1,0.9,2004,FW,1,1,2,0,"",0,0,0,0,1,2,1,1,3,0,1
e613313c,Perr Schuurs,23,Torino,Serie A,8.6,1999,DF,8,2,10,3,33.3,9,6,23,0,9,20,1,11,29,8,12
e61b8aee,Granit Xhaka,30,Leverkusen,Bundesliga,31.3,1992,MF,21,8,29,9,30.0,30,21,42,0,19,29,4,11,48,14,21
e6536124,Patrick Dorgu,18,Lecce,Serie A,17.4,2004,"DF,MF",11,5,16,22,64.7,34,12,45,2,9,43,4,22,52,17,22
e6697917,Domingos Andre Ribeiro Almeida,23,Valencia,La Liga,10.7,2000,"FW,MF",12,1,13,9,47.4,19,10,5,0,6,25,4,9,31,12,15
e6777e6b,Stefan Mitrovic,33,Getafe,La Liga,7.8,1990,DF,1,2,3,4,50.0,8,4,26,0,6,9,0,7,15,2,3
e6af02e0,Matheus Nunes,24,Manchester City,Premier League,7.3,1998,MF,6,1,7,5,31.3,16,11,8,1,1,10,2,1,11,7,4
e6bc67d7,Goncalo Guedes,26,Villarreal,La Liga,10.6,1996,"FW,MF",8,0,8,2,28.6,7,5,3,0,2,6,3,1,8,2,4
e6c43eec,Josuha Guilavogui,32,Mainz 05,Bundesliga,4.5,1990,DF,6,7,13,6,85.7,7,1,21,0,13,15,0,10,28,5,10
e717705a,Alex Kral,25,Union Berlin,Bundesliga,15.2,1998,MF,11,4,15,8,40.0,20,12,30,0,11,19,2,7,30,10,14
e74f0e59,Lorenzo De Silvestri,35,Bologna,Serie A,7.5,1988,DF,5,4,9,4,57.1,7,3,27,0,6,10,3,5,16,2,8
e75129bd,Noah Mbamba,18,Leverkusen,Bundesliga,0.2,2005,MF,0,0,0,0,"",0,0,0,0,1,0,0,0,1,0,0
e7630876,Mika Marmol,21,Las Palmas,La Liga,35.3,2002,DF,20,19,39,35,66.0,53,18,147,2,44,70,2,44,114,24,42
e768de1f,Habib Maiga,27,Metz,Ligue 1,1.6,1996,"MF,FW",2,0,2,1,33.3,3,2,2,0,4,2,1,1,6,0,2
e7695e6c,Mateo Retegui,24,Genoa,Serie A,24.6,1999,FW,16,2,18,6,30.0,20,14,30,0,0,17,2,7,17,8,9
e76cb9cc,Chancel Mbemba,28,Marseille,Ligue 1,24.5,1994,DF,8,13,21,17,56.7,30,13,95,1,13,33,1,25,46,7,21
e77dc3b2,Dominic Solanke,25,Bournemouth,Premier League,36.9,1997,FW,19,5,24,10,34.5,29,19,43,0,7,23,7,3,30,13,11
e79269bd,Luca Netz,20,Gladbach,Bundesliga,24.7,2003,DF,26,10,36,23,53.5,43,20,76,1,22,38,3,19,60,16,22
e7aa9d7c,Fabio Silva,21,Wolves,Premier League,2.9,2002,FW,1,0,1,2,66.7,3,1,0,0,2,7,0,3,9,4,4
e7af9060,Cyle Larin,28,Mallorca,La Liga,20.3,1995,FW,11,5,16,2,28.6,7,5,17,0,3,17,7,6,20,4,8
e7ca0439,James Tomkins,34,Crystal Palace,Premier League,0.1,1989,DF,0,0,0,0,"",0,0,0,0,1,0,0,0,1,0,0
e7d59f4f,Amine Harit,26,Marseille,Ligue 1,20.2,1997,"MF,FW",27,4,31,13,35.1,37,24,4,0,12,28,3,8,40,17,16
e7f4869a,Oscar Vilhelmsson,19,Darmstadt 98,Bundesliga,15.3,2003,"FW,MF",10,5,15,7,70.0,10,3,19,0,3,13,3,3,16,7,6
e7fcf289,Florian Wirtz,20,Leverkusen,Bundesliga,26.4,2003,MF,34,2,36,9,31.0,29,20,3,0,9,27,6,7,36,14,18
e814e1cf,Lewis Dobbin,20,Everton,Premier League,2.6,2003,MF,4,1,5,5,55.6,9,4,0,0,1,9,1,3,10,5,7
e8271ad9,Jordan Zemura,23,Udinese,Serie A,11.5,1999,DF,4,1,5,11,57.9,19,8,21,0,13,24,4,13,37,7,16
e82900ef,David Datro Fofana,20,Union Berlin,Bundesliga,7.6,2002,"FW,MF",4,0,4,4,44.4,9,5,5,0,0,10,2,3,10,5,7
e82adcab,Exequiel Palacios,24,Leverkusen,Bundesliga,20.3,1998,MF,24,0,24,26,49.1,53,27,20,2,29,60,6,28,89,26,34
e83e8928,Xabier Huarte Armendariz,22,Osasuna,La Liga,0.1,2001,MF,0,0,0,0,"",0,0,0,0,0,0,0,0,0,0,0
e87c44a9,Asier Osambela,19,Osasuna,La Liga,0.1,2004,MF,0,0,0,0,"",0,0,0,0,0,2,1,0,2,1,1
e8832875,Joao Pedro,21,Brighton,Premier League,22.7,2001,"FW,MF",13,2,15,14,58.3,24,10,28,0,11,31,8,10,42,13,14
e897d8ba,Kike,33,Alavés,La Liga,15.8,1989,"FW,MF",11,5,16,4,44.4,9,5,12,0,1,8,3,2,9,3,4
e8a65bc8,Bilal Boutobba,24,Clermont Foot,Ligue 1,10.3,1998,"FW,MF",9,0,9,10,43.5,23,13,3,0,8,22,6,6,30,10,12
e8c930bb,Milan Badelj,34,Genoa,Serie A,28.2,1989,MF,32,13,45,24,39.3,61,37,54,1,50,51,4,23,101,24,27
e8ef59da,Yorbe Vertessen,22,Union Berlin,Bundesliga,6.6,2001,"FW,MF",8,0,8,1,25.0,4,3,3,0,1,3,0,0,4,3,2
e9241b40,Luca de la Torre,25,Celta Vigo,La Liga,21.7,1998,MF,19,4,23,22,51.2,43,21,17,0,12,39,5,12,51,22,21
e92cd3f7,Alexander Sorloth,27,Villarreal,La Liga,27.7,1995,FW,5,4,9,2,33.3,6,4,26,0,0,6,3,1,6,2,3
e97fd090,Ruben Loftus-Cheek,27,Milan,Serie A,23.0,1996,MF,12,12,24,15,55.6,27,12,10,1,9,28,7,7,37,14,18
e980e78d,Adryelson,25,Lyon,Ligue 1,0.1,1998,"DF,FW",0,0,0,0,"",0,0,3,0,1,0,0,0,1,0,0
e98211e7,Jack Hinshelwood,18,Brighton,Premier League,9.7,2005,DF,4,2,6,5,38.5,13,8,18,0,14,14,3,7,28,4,5
e9a97974,Braydon Manu,26,Darmstadt 98,Bundesliga,1.9,1997,MF,1,0,1,0,"",0,0,0,0,0,2,1,0,2,1,0
e9ada8cf,Javi Lopez,21,Alavés,La Liga,26.5,2002,DF,16,9,25,15,57.7,26,11,77,1,10,23,3,11,33,9,12
ea02beaf,Remi Oudin,26,Lecce,Serie A,20.2,1996,"MF,FW",12,1,13,12,63.2,19,7,22,0,20,26,2,12,46,12,14
ea0893d6,Kelvin Yeboah,23,Montpellier,Ligue 1,3.1,2000,FW,1,2,3,1,33.3,3,2,3,0,1,4,0,2,5,2,2
ea0aa7e0,Mihailo Ristic,27,Celta Vigo,La Liga,9.0,1995,"DF,MF",7,2,9,9,75.0,12,3,23,0,10,15,0,9,25,6,9
ea1a5662,Myles Peart-Harris,20,Brentford,Premier League,0.1,2002,"DF,MF",0,0,0,0,"",0,0,1,0,0,0,0,0,0,0,0
ea6bc03a,Robin Koch,27,Eint Frankfurt,Bundesliga,30.4,1996,DF,9,24,33,17,63.0,27,10,136,2,32,38,0,26,70,12,23
eab957a3,Anel Ahmedhodzic,24,Sheffield Utd,Premier League,29.4,1999,DF,17,26,43,30,61.2,49,19,137,2,35,64,2,48,99,14,36
eabef312,Ilhan Fakili,17,Clermont Foot,Ligue 1,1.0,2006,"MF,FW",1,0,1,0,0.0,1,1,0,0,1,0,0,0,1,0,0
ead61f73,Juan Miranda,23,Betis,La Liga,20.6,2000,DF,25,6,31,17,54.8,31,14,62,0,19,38,4,21,57,13,24
eaeca114,Nathan Ake,28,Manchester City,Premier League,22.7,1995,DF,15,2,17,13,65.0,20,7,54,0,14,26,3,15,40,8,16
eb0ec070,Pasquale Mazzocchi,28,Napoli,Serie A,4.8,1995,DF,4,1,5,2,66.7,3,1,13,0,1,5,2,1,6,2,2
eb2fe5b6,Luis Muriel,32,Atalanta,Serie A,4.5,1991,"FW,MF",4,0,4,1,100.0,1,0,0,0,1,3,1,0,4,2,2
eb3dd471,Luis Rioja,29,Alavés,La Liga,27.8,1993,"FW,MF",27,1,28,14,32.6,43,29,28,0,16,27,5,10,43,12,19
eb6e14be,Mergim Berisha,25,Augsburg,Bundesliga,1.4,1998,FW,1,0,1,0,"",0,0,3,0,0,0,0,0,0,0,0
eb7822d7,Nemanja Matic,34,Lyon,Ligue 1,13.9,1988,MF,11,6,17,9,47.4,19,10,17,1,16,17,2,8,33,7,11
eba1e557,Han-Noah Massengo,22,Burnley,Premier League,0.2,2001,"MF,DF",1,0,1,0,"",0,0,0,0,0,1,0,1,1,0,1
ec11ecf8,Chris Bedia,27,Union Berlin,Bundesliga,1.6,1996,"FW,MF",3,0,3,0,0.0,1,1,2,0,0,2,0,0,2,2,1
ec1a731e,Victor Chust,23,Cádiz,La Liga,20.7,2000,DF,6,21,27,18,56.3,32,14,92,1,11,29,1,23,40,5,18
ec315772,Santiago Pierotti,22,Lecce,Serie A,2.2,2001,"MF,FW",5,0,5,2,25.0,8,6,0,0,1,8,1,2,9,5,8
ec52b661,Emanuele Valeri,24,Frosinone,Serie A,13.1,1998,DF,11,3,14,10,47.6,21,11,22,0,9,19,4,10,28,5,16
ec5dae45,Emanuel Vignato,22,Salernitana,Serie A,3.5,2000,"MF,FW",1,0,1,5,83.3,6,1,7,0,1,10,1,4,11,5,7
ec68a918,Mert Komur,18,Augsburg,Bundesliga,1.3,2005,"MF,DF",0,0,0,3,60.0,5,2,1,0,0,3,0,3,3,0,3
ec7c84c2,Javier Munoz,28,Las Palmas,La Liga,29.3,1995,MF,36,4,40,16,36.4,44,28,29,1,20,42,6,14,62,22,23
ecad9aa5,Romeo Lavia,19,Chelsea,Premier League,0.4,2004,MF,0,0,0,0,"",0,0,1,0,0,1,0,0,1,1,0
ecbe2839,Willian Pacho,21,Eint Frankfurt,Bundesliga,33.0,2001,DF,29,22,51,31,58.5,53,22,152,2,47,62,1,38,109,23,37
ed1e53f3,Phil Foden,23,Manchester City,Premier League,31.7,2000,"FW,MF",30,0,30,13,41.9,31,18,18,1,13,31,10,11,44,10,20
ed383e43,Alex Matos,18,Chelsea,Premier League,0.0,2004,MF,0,0,0,0,"",0,0,0,0,0,0,0,0,0,0,0
ed45c4a5,Valentin Rongier,28,Marseille,Ligue 1,9.5,1994,MF,12,4,16,14,53.8,26,12,18,0,15,23,2,9,38,12,12
ed55b838,Gelabert,22,Toulouse,Ligue 1,8.4,2000,"MF,FW",6,2,8,7,35.0,20,13,8,0,5,14,3,5,19,6,8
ed5c0319,Beto,25,Udinese,Serie A,0.8,1998,FW,0,0,0,0,"",0,0,0,0,0,1,1,0,1,0,0
ed5c5fa3,Fran Beltran,24,Celta Vigo,La Liga,27.0,1999,MF,26,2,28,24,38.1,63,39,34,0,18,56,11,22,74,23,32
ed6ea4d9,Darwin Machis,30,Cádiz,La Liga,8.7,1993,MF,7,1,8,13,54.2,24,11,2,0,4,23,7,7,27,9,14
ed79b7d3,Ermedin Demirovic,25,Augsburg,Bundesliga,31.9,1998,"FW,MF",26,2,28,12,30.0,40,28,26,0,11,24,3,5,35,16,14
ed90babd,Adam Ounas,26,Lille,Ligue 1,4.6,1996,FW,2,0,2,2,28.6,7,5,1,0,6,4,0,2,10,2,3
ed98c321,Tim Breithaupt,21,Augsburg,Bundesliga,7.0,2002,MF,12,3,15,13,61.9,21,8,10,0,8,20,0,11,28,9,11
ed9f7cfe,Renan Lodi,25,Marseille,Ligue 1,13.7,1998,DF,5,2,7,13,61.9,21,8,35,0,16,24,3,8,40,13,16
eda38706,Adson,22,Nantes,Ligue 1,2.6,2000,"MF,FW",5,0,5,2,100.0,2,0,2,0,2,7,0,1,9,6,6
edb2712b,Maximilian Wittek,27,Bochum,Bundesliga,11.9,1995,"DF,FW",11,1,12,13,61.9,21,8,23,0,18,23,3,9,41,11,17
edc98fac,Santiago Bueno,24,Wolves,Premier League,9.1,1998,DF,10,12,22,5,45.5,11,6,33,0,6,13,1,5,19,7,7
edd4e7a5,Yoel Lago,19,Celta Vigo,La Liga,1.0,2004,DF,1,0,1,0,"",0,0,2,0,0,2,0,2,2,0,0
edd81e2a,Dylan Bronn,28,Salernitana,Serie A,0.6,1995,"DF,MF",2,0,2,0,0.0,1,1,4,0,0,0,0,0,0,0,0
ee158be5,Junior Mwanga,20,Strasbourg,Ligue 1,16.1,2003,"MF,FW",15,5,20,12,50.0,24,12,19,0,18,40,5,23,58,12,20
ee251371,Alexis Saelemaekers,24,Bologna,Serie A,21.0,1999,"FW,MF",12,1,13,12,44.4,27,15,10,1,13,32,5,13,45,14,22
ee38d9c5,James Maddison,26,Tottenham,Premier League,23.7,1996,MF,12,3,15,15,51.7,29,14,10,1,13,33,10,5,46,18,19
ee45fd85,Vanderson,22,Monaco,Ligue 1,18.2,2001,DF,27,2,29,32,45.7,70,38,37,1,35,60,10,20,95,30,41
ee5565ae,Santiago Castro,18,Bologna,Serie A,2.7,2004,FW,1,0,1,1,33.3,3,2,1,0,1,2,1,0,3,1,1
ee644761,Moritz Jenz,24,Wolfsburg,Bundesliga,19.4,1999,DF,12,17,29,14,66.7,21,7,94,0,26,34,2,21,60,11,24
ee64a822,Lewis Ferguson,23,Bologna,Serie A,30.1,1999,MF,17,8,25,16,43.2,37,21,27,1,17,37,4,16,54,17,21
ee6e2b92,Chaka Traore,18,Milan,Serie A,0.2,2004,FW,0,1,1,1,50.0,2,1,0,0,0,2,0,2,2,0,1
ee923664,Kevin Vazquez,30,Celta Vigo,La Liga,7.8,1993,DF,8,3,11,12,57.1,21,9,25,0,5,15,1,7,20,7,13
eeba07f8,Luis Javier Suarez,25,Almería,La Liga,10.2,1997,FW,11,0,11,2,33.3,6,4,13,0,0,7,0,2,7,5,5
eebacc07,Gustavo Hamer,26,Sheffield Utd,Premier League,32.3,1997,MF,24,9,33,16,27.1,59,43,35,0,29,39,7,17,68,15,21
eed2427e,Oscar Bobb,20,Manchester City,Premier League,3.4,2003,"FW,MF",4,0,4,2,50.0,4,2,1,0,5,7,4,1,12,2,3
eef3f9c6,"Jean Frederic N'Guessan",20,Metz,Ligue 1,1.2,2003,"MF,FW",3,0,3,0,0.0,3,3,0,0,1,3,0,0,4,3,1
ef2e5e1a,Kevin Strootman,33,Genoa,Serie A,13.4,1990,MF,14,6,20,15,48.4,31,16,22,0,7,34,3,13,41,18,19
ef322658,Andres Guardado,36,Betis,La Liga,5.0,1986,MF,2,2,4,7,50.0,14,7,5,0,6,17,3,5,23,9,12
ef3c876b,Ylber Ramadani,27,Lecce,Serie A,33.0,1996,MF,41,13,54,37,38.5,96,59,44,0,44,68,7,32,112,29,41
ef6eef89,Juan David Cabal,22,Hellas Verona,Serie A,16.6,2001,DF,21,9,30,18,62.1,29,11,55,2,26,36,3,19,62,14,27
ef7cd87a,Abdoulaye Toure,29,Le Havre,Ligue 1,25.4,1994,MF,22,8,30,30,50.0,60,30,33,0,25,47,3,22,72,22,28
ef97654b,Jonathan Norbye,16,RB Leipzig,Bundesliga,0.0,2007,MF,0,0,0,0,"",0,0,0,0,0,0,0,0,0,0,0
ef9c1c95,Benjamin Andre,32,Lille,Ligue 1,28.6,1990,MF,29,5,34,43,53.1,81,38,60,0,35,89,5,39,124,45,49
efa708aa,Jonathan Viera,33,Almería,La Liga,10.1,1989,MF,4,0,4,10,52.6,19,9,1,0,4,19,4,6,23,9,9
efaefda0,Marvin,23,Las Palmas,La Liga,20.6,2000,"FW,DF",26,2,28,18,50.0,36,18,18,1,14,39,4,18,53,17,25
efc9e31f,Dany Mota,25,Monza,Serie A,22.8,1998,"FW,MF",3,1,4,8,47.1,17,9,18,0,2,13,6,2,15,5,7
efd2ec23,Antoine Semenyo,23,Bournemouth,Premier League,23.4,2000,FW,37,2,39,9,33.3,27,18,21,0,6,24,8,7,30,9,17
efecd633,Fede San Emeterio,26,Cádiz,La Liga,1.7,1997,MF,1,2,3,1,25.0,4,3,1,0,2,3,0,2,5,1,2
eff9c9ea,Charlys,19,Hellas Verona,Serie A,0.3,2004,MF,0,0,0,0,"",0,0,0,0,1,0,0,0,1,0,0
f02067df,"Joshua M'Bahia",18,Clermont Foot,Ligue 1,0.2,2005,MF,0,0,0,0,"",0,0,0,0,0,0,0,0,0,0,0
f025eade,Joan Gonzalez,21,Lecce,Serie A,14.3,2002,MF,17,3,20,17,60.7,28,11,9,0,5,31,3,16,36,12,18
f03f284b,David Lopez,33,Girona,La Liga,21.8,1989,DF,9,19,28,17,77.3,22,5,63,4,20,33,0,21,53,12,20
f066022d,Julien Laporte,29,Lorient,Ligue 1,20.2,1993,DF,10,26,36,16,44.4,36,20,116,1,11,23,1,15,34,7,14
f0661424,Nicolas Tagliafico,30,Lyon,Ligue 1,23.6,1992,DF,17,8,25,22,44.9,49,27,43,0,28,54,9,23,82,22,34
f08490a6,Arnaut Danjuma,26,Everton,Premier League,6.6,1997,"MF,FW",4,0,4,1,25.0,4,3,0,0,3,6,1,2,9,3,4
f098c03e,Mads Juel Andersen,25,Luton Town,Premier League,4.4,1997,DF,3,6,9,4,100.0,4,0,29,0,8,6,0,4,14,2,5
f0caab96,Toti Gomes,24,Wolves,Premier League,30.8,1999,DF,21,19,40,24,64.9,37,13,93,2,26,44,4,32,70,8,25
f0da930c,Jose Maria Gimenez,28,Atlético Madrid,La Liga,14.7,1995,DF,4,12,16,5,31.3,16,11,95,0,10,18,1,10,28,7,10
f0f499ea,Karl Etta,19,Cádiz,La Liga,0.2,2004,FW,0,0,0,0,"",0,0,0,0,0,1,0,0,1,1,1
f1124008,Gorka Rivera Alonso,18,Getafe,La Liga,0.0,2004,DF,0,0,0,0,"",0,0,0,0,0,0,0,0,0,0,0
f15f8b2b,Musa Al-Taamari,26,Montpellier,Ligue 1,21.4,1997,FW,16,2,18,9,42.9,21,12,5,0,4,20,5,10,24,5,16
f18d7ab2,Andy Pelmard,23,Clermont Foot,Ligue 1,33.2,2000,DF,17,20,37,32,80.0,40,8,99,2,33,51,1,41,84,9,38
f1c42eb3,Alex Murphy,19,Newcastle Utd,Premier League,0.1,2004,"DF,FW",1,0,1,1,50.0,2,1,0,0,1,1,0,0,2,1,1
f1e94cd6,Nathan Tella,24,Leverkusen,Bundesliga,9.1,1999,"DF,MF",10,0,10,5,50.0,10,5,8,0,3,13,2,6,16,5,8
f20e4cc9,Nuno Mendes,21,Paris S-G,Ligue 1,3.0,2002,DF,4,0,4,4,57.1,7,3,2,0,4,5,0,4,9,1,5
f230bc30,Jakub Moder,24,Brighton,Premier League,6.9,1999,"MF,DF",6,2,8,9,50.0,18,9,12,0,2,19,5,9,21,5,10
f24ea523,Genki Haraguchi,32,Stuttgart,Bundesliga,0.3,1991,MF,0,0,0,0,"",0,0,1,0,0,1,0,1,1,0,1
f25c8e3a,Naby Keita,28,Werder Bremen,Bundesliga,1.2,1995,"MF,DF",2,0,2,0,0.0,1,1,1,0,2,1,0,1,3,0,1
f25de136,Ahmed Touba,25,Lecce,Serie A,3.1,1998,DF,1,3,4,3,75.0,4,1,20,0,7,6,0,3,13,3,4
f26834c7,Karim Onisiwo,31,Mainz 05,Bundesliga,16.6,1992,"FW,MF",14,4,18,6,54.5,11,5,7,0,2,17,7,4,19,6,8
f27680d9,Cristian Gamboa,33,Bochum,Bundesliga,13.2,1989,DF,13,7,20,14,42.4,33,19,34,1,15,24,1,12,39,11,18
f28474a4,Henrique,29,Lyon,Ligue 1,6.7,1994,DF,6,2,8,6,54.5,11,5,3,0,10,10,0,6,20,4,6
f2c6ac01,Martin Valjent,27,Mallorca,La Liga,26.1,1995,DF,15,11,26,18,60.0,30,12,112,1,29,34,2,19,63,13,18
f315ca93,Kostas Tsimikas,27,Liverpool,Premier League,7.5,1996,DF,8,1,9,9,60.0,15,6,10,0,6,19,4,9,25,6,13
f31def1e,Lloyd Kelly,24,Bournemouth,Premier League,17.3,1998,DF,10,12,22,14,56.0,25,11,67,0,13,24,5,10,37,9,19
f323d995,Christopher Jullien,30,Montpellier,Ligue 1,13.7,1993,DF,5,20,25,6,35.3,17,11,106,2,12,16,0,11,28,5,12
f33b6ee6,Pablo Gozalbez,22,Valencia,La Liga,1.1,2001,"MF,FW",0,0,0,1,16.7,6,5,2,0,1,1,1,0,2,0,0
f35430a4,Matija Nastasic,30,Mallorca,La Liga,25.1,1993,DF,13,20,33,24,75.0,32,8,114,0,29,35,0,26,64,9,17
f36016a5,Ramon Terrats,22,Villarreal,La Liga,8.7,2000,"MF,DF",10,1,11,7,46.7,15,8,9,0,3,17,1,8,20,8,13
f365b837,Joseph Nduquidi,18,Metz,Ligue 1,8.3,2004,"MF,DF",8,3,11,1,11.1,9,8,15,1,11,11,2,6,22,3,4
f36d5624,Luis Henrique,21,Marseille,Ligue 1,8.7,2001,"FW,DF",9,0,9,4,57.1,7,3,3,0,8,8,3,4,16,1,7
f37f3522,Antoine Makoumbou,25,Cagliari,Serie A,30.0,1998,MF,19,4,23,15,50.0,30,15,27,2,16,41,5,21,57,15,24
f3b1d9a2,Amath,27,Mallorca,La Liga,4.4,1996,"FW,MF",2,0,2,2,20.0,10,8,6,0,3,9,0,7,12,2,6
f40e77d9,Saimon Bouabre,17,Monaco,Ligue 1,0.5,2006,MF,1,0,1,1,50.0,2,1,0,0,0,2,0,0,2,2,2
f4290206,Marcos Alonso,32,Barcelona,La Liga,2.8,1990,DF,2,0,2,3,75.0,4,1,6,0,4,5,0,2,9,3,3
f42d6c13,Nedim Bajrami,24,Sassuolo,Serie A,14.6,1999,"MF,FW",4,1,5,5,38.5,13,8,8,0,6,13,4,6,19,3,6
f449640d,Fode Ballo-Toure,26,Fulham,Premier League,0.8,1997,"DF,MF",1,0,1,1,50.0,2,1,2,0,3,4,0,1,7,3,2
f44e8a73,Omar Traore,25,Heidenheim,Bundesliga,27.5,1998,DF,25,7,32,32,57.1,56,24,54,1,40,60,6,33,100,21,33
f4547573,Lamine Diack,22,Nantes,Ligue 1,0.0,2000,MF,0,0,0,0,"",0,0,0,0,0,0,0,0,0,0,0
f4797849,Koni De Winter,21,Genoa,Serie A,26.4,2002,DF,20,10,30,21,67.7,31,10,78,0,21,44,5,26,65,13,25
f49c4ae9,Junior Messias,32,Genoa,Serie A,11.7,1991,"MF,DF",8,1,9,8,42.1,19,11,22,0,5,26,2,19,31,5,20
f4c69aa6,Ilaix Moriba,20,Getafe,La Liga,6.7,2003,"MF,FW",2,1,3,4,44.4,9,5,10,0,4,20,6,3,24,11,11
f4d60499,Morten Frendrup,22,Genoa,Serie A,34.9,2001,MF,41,14,55,55,60.4,91,36,42,1,51,133,16,47,184,70,72
f4e433d4,Tariq Lamptey,22,Brighton,Premier League,10.2,2000,"DF,FW",4,3,7,13,59.1,22,9,6,0,6,21,2,14,27,5,14
f5044e54,Pierre Lees-Melou,30,Brest,Ligue 1,28.0,1993,MF,50,11,61,49,38.0,129,80,64,3,43,96,4,51,139,41,67
f521b80a,Matthias Ginter,29,Freiburg,Bundesliga,21.3,1994,DF,14,26,40,16,55.2,29,13,93,0,16,29,1,19,45,9,15
f527a32c,Muhammed Cham,22,Clermont Foot,Ligue 1,28.4,2000,"MF,FW",18,2,20,11,40.7,27,16,5,1,8,25,2,10,33,13,14
f553b2b3,Jorgen Strand Larsen,23,Celta Vigo,La Liga,31.8,2000,FW,14,1,15,8,21.1,38,30,17,0,5,21,5,1,26,15,11
f573a8bf,Isaac Success,27,Udinese,Serie A,9.8,1996,"FW,MF",5,1,6,1,33.3,3,2,11,0,2,6,1,0,8,5,4
f586779e,Tammy Abraham,25,Roma,Serie A,2.7,1997,FW,1,0,1,0,"",0,0,4,0,0,3,2,0,3,1,1
f5b281e7,Niels Nkounkou,22,Eint Frankfurt,Bundesliga,14.5,2000,"DF,MF",28,2,30,29,45.3,64,35,30,0,16,54,3,34,70,17,30
f5c4fd91,Arijon Ibrahimovic,17,Frosinone,Serie A,5.3,2005,"FW,DF",4,0,4,1,11.1,9,8,3,0,1,7,1,4,8,2,6
f5c8b425,Yusuf Yazici,26,Lille,Ligue 1,14.6,1997,"MF,FW",9,1,10,4,26.7,15,11,5,0,5,19,4,6,24,9,11
f5deef4c,Victor Lindelof,29,Manchester Utd,Premier League,14.8,1994,DF,9,9,18,5,38.5,13,8,40,1,12,15,0,8,27,7,10
f631c17f,Oliver Burke,26,Werder Bremen,Bundesliga,0.4,1997,FW,0,0,0,0,0.0,2,2,0,0,0,0,0,0,0,0,0
f63cda26,Goncalo Ramos,22,Paris S-G,Ligue 1,15.8,2001,FW,10,2,12,6,30.0,20,14,16,0,5,25,9,4,30,12,15
f67c9d29,Danilho Doekhi,25,Union Berlin,Bundesliga,24.0,1998,DF,21,25,46,15,71.4,21,6,111,1,38,34,0,18,72,16,23
f6857b4f,Axel Gueguin,18,Montpellier,Ligue 1,1.5,2005,"DF,FW",2,0,2,2,33.3,6,4,6,0,2,9,1,6,11,2,5
f68b64fc,Silvan Widmer,30,Mainz 05,Bundesliga,13.8,1993,DF,13,5,18,17,60.7,28,11,37,0,16,23,3,12,39,8,10
f6a3c84d,Kevin Van Den Kerkhof,27,Metz,Ligue 1,21.3,1996,"FW,MF",13,2,15,13,40.6,32,19,32,1,11,31,7,11,42,13,24
f6ac68c1,Stefan Savic,32,Atlético Madrid,La Liga,18.1,1991,DF,14,15,29,15,50.0,30,15,61,1,27,27,4,16,54,7,19
f6b94e8d,Saidou Sow,21,Strasbourg,Ligue 1,8.0,2002,DF,3,4,7,9,69.2,13,4,36,3,12,20,0,17,32,3,12
f6bdc830,Keven Schlotterbeck,26,Bochum,Bundesliga,24.3,1997,DF,10,23,33,25,83.3,30,5,104,2,33,42,2,26,75,14,22
f6d7d690,Josh Cullen,27,Burnley,Premier League,22.9,1996,MF,12,19,31,26,56.5,46,20,26,1,15,42,5,15,57,22,29
f7036e1c,Lautaro Martinez,25,Inter,Serie A,29.5,1997,FW,29,1,30,4,21.1,19,15,10,0,20,22,5,4,42,13,16
f7223718,Patric,30,Lazio,Serie A,17.9,1993,DF,6,9,15,8,44.4,18,10,44,0,6,13,0,10,19,3,8
f72293fc,Johann Berg Gudmundsson,32,Burnley,Premier League,13.2,1990,"MF,FW",14,0,14,7,43.8,16,9,16,0,16,13,2,6,29,5,4
f76022e7,Enzo Millot,21,Stuttgart,Bundesliga,24.9,2002,"MF,FW",22,2,24,18,46.2,39,21,7,1,16,40,10,9,56,21,22
f761c901,Tim Siersleben,23,Heidenheim,Bundesliga,10.1,2000,DF,6,10,16,8,40.0,20,12,29,1,21,27,0,21,48,6,11
f7b1d4e0,Saman Ghoddos,29,Brentford,Premier League,8.2,1993,DF,7,2,9,17,54.8,31,14,12,0,5,28,2,19,33,7,19
f7c12fbf,Hugo Guillamon,23,Valencia,La Liga,14.6,2000,MF,5,3,8,11,64.7,17,6,25,2,12,24,3,7,36,14,15
f7c491f1,Nehuen Perez,23,Udinese,Serie A,36.0,2000,DF,27,26,53,39,81.3,48,9,158,1,45,72,2,42,117,28,48
f7dc2ae5,Aritz Elustondo,29,Real Sociedad,La Liga,9.0,1994,DF,2,10,12,6,42.9,14,8,26,0,7,11,2,5,18,4,7
f7e2af2c,Andrea Carboni,22,Monza,Serie A,16.5,2001,DF,10,13,23,20,64.5,31,11,56,1,17,38,2,24,55,12,22
f7e87032,Viktor Tsyhankov,25,Girona,La Liga,22.8,1997,"MF,FW",17,1,18,14,53.8,26,12,24,0,12,29,5,11,41,13,20
f814e5d3,Cristian Herrera,32,Las Palmas,La Liga,1.8,1991,"FW,MF",1,0,1,1,50.0,2,1,2,0,0,1,0,0,1,1,1
f81ef10d,Maxence Caqueret,23,Lyon,Ligue 1,33.6,2000,MF,31,9,40,38,35.5,107,69,26,2,48,91,15,39,139,37,64
f833a830,Takumi Minamino,28,Monaco,Ligue 1,23.5,1995,MF,28,1,29,16,29.6,54,38,8,0,11,34,11,10,45,13,17
f8342731,Silvan Hefti,25,Montpellier,Ligue 1,7.9,1997,"DF,FW",5,2,7,15,51.7,29,14,11,0,8,21,4,10,29,7,15
f83f6de1,Gerardo Fusco,18,Salernitana,Serie A,0.2,2005,FW,0,0,0,0,"",0,0,0,0,0,0,0,0,0,0,0
f8405304,Mohamed Ali Cho,19,Nice,Ligue 1,9.6,2004,FW,10,0,10,3,27.3,11,8,6,0,3,12,1,4,15,7,9
f84a807c,Lyle Foster,22,Burnley,Premier League,21.1,2000,"FW,MF",10,3,13,6,35.3,17,11,34,0,3,19,8,5,22,6,10
f86ad3f5,Marco Friedl,25,Werder Bremen,Bundesliga,24.4,1998,DF,16,29,45,36,75.0,48,12,129,0,35,53,0,38,88,15,32
f86cd5df,Aster Vranckx,20,Wolfsburg,Bundesliga,12.8,2002,MF,11,6,17,15,53.6,28,13,29,0,14,32,10,11,46,11,15
f86fe8c1,Cristian Casseres Jr.,23,Toulouse,Ligue 1,21.6,2000,MF,30,4,34,29,47.5,61,32,33,1,27,70,6,31,97,33,34
f874dd44,Hector Bellerin,28,Betis,La Liga,19.0,1995,DF,8,5,13,20,37.7,53,33,40,1,22,34,4,14,56,16,22
f8eca1b6,Enes Unal,26,Getafe,La Liga,1.6,1997,"FW,MF",1,0,1,0,"",0,0,2,0,0,0,0,0,0,0,0
f8fcd2a5,Jonny Evans,35,Manchester Utd,Premier League,15.5,1988,DF,7,18,25,12,57.1,21,9,76,0,23,22,0,20,45,2,14
f9124307,Antoine Joujou,20,Le Havre,Ligue 1,8.7,2003,"FW,MF",9,2,11,11,52.4,21,10,5,0,7,20,6,7,27,7,12
f95f49d2,Yayah Kallon,22,Hellas Verona,Serie A,0.0,2001,FW,0,0,0,0,"",0,0,0,0,0,0,0,0,0,0,0
f972644c,Marco Richter,25,Mainz 05,Bundesliga,8.0,1997,"MF,FW",9,0,9,4,36.4,11,7,1,0,2,10,2,5,12,3,4
f9758dae,Emmanuel Gyasi,29,Empoli,Serie A,20.9,1994,"DF,FW",18,12,30,15,46.9,32,17,27,1,5,34,3,18,39,13,17
f97f9188,Giovanni Fabbian,20,Bologna,Serie A,11.7,2003,"MF,FW",3,2,5,7,58.3,12,5,11,0,7,17,1,9,24,7,10
f999e9be,Tom Louchet,20,Nice,Ligue 1,4.5,2003,"MF,DF",4,3,7,7,63.6,11,4,9,0,3,14,2,6,17,6,5
f9c927de,Michel Aebischer,26,Bologna,Serie A,24.8,1997,MF,22,6,28,15,44.1,34,19,22,0,12,35,6,9,47,20,20
f9d5908e,Hicham Boudaoui,23,Nice,Ligue 1,17.9,1999,MF,14,1,15,21,70.0,30,9,15,0,11,41,3,16,52,22,19
fa031b34,Richarlison,26,Tottenham,Premier League,16.6,1997,FW,26,6,32,2,20.0,10,8,23,0,8,16,4,4,24,8,11
fa449bba,Nicolas Haas,27,Empoli,Serie A,1.0,1996,MF,1,0,1,3,100.0,3,0,1,0,1,5,2,1,6,2,3
fa661778,Marius Wolf,28,Dortmund,Bundesliga,13.0,1995,DF,10,2,12,11,47.8,23,12,20,0,8,20,1,8,28,11,12
faa13947,Alejandro Jimenez,18,Milan,Serie A,0.8,2005,DF,0,0,0,2,40.0,5,3,4,0,0,2,0,2,2,0,1
fadf9a05,Thomas Kristensen,21,Udinese,Serie A,23.3,2002,DF,9,20,29,21,63.6,33,12,118,0,29,35,0,25,64,10,24
faed84db,Uros Racic,25,Sassuolo,Serie A,9.1,1998,MF,9,7,16,0,0.0,9,9,22,0,7,10,0,6,17,4,4
faf00ab8,Khalil Fayad,19,Montpellier,Ligue 1,11.4,2004,"FW,MF",12,3,15,9,40.9,22,13,6,0,14,28,4,17,42,7,15
fb14aa28,Mama Samba Balde,27,Lyon,Ligue 1,6.1,1995,"FW,MF",0,0,0,3,33.3,9,6,1,1,3,8,5,1,11,2,5
fb377d11,Josha Vagnoman,22,Stuttgart,Bundesliga,13.1,2000,DF,6,5,11,15,50.0,30,15,16,1,2,28,2,15,30,11,18
fb37a645,Joao Ferreira,22,Udinese,Serie A,20.2,2001,DF,21,6,27,34,58.6,58,24,89,0,29,58,4,36,87,18,42
fb4c5b6e,Nathan Zeze,18,Nantes,Ligue 1,11.4,2005,DF,9,3,12,7,50.0,14,7,47,1,12,11,0,9,23,2,6
fb6316d5,Joel Imasuen,18,Werder Bremen,Bundesliga,0.0,2004,FW,0,0,0,0,"",0,0,0,0,0,0,0,0,0,0,0
fb77bfef,Kevin Bonifazi,27,Frosinone,Serie A,3.4,1996,DF,1,0,1,2,66.7,3,1,9,0,3,5,0,2,8,3,3
fb920f3a,Cesare Casadei,20,Chelsea,Premier League,0.9,2003,"FW,MF",1,0,1,2,40.0,5,3,4,0,0,5,2,2,5,1,3
fb938d24,Jesus Corona,30,Sevilla,La Liga,0.2,1993,"MF,DF",0,0,0,0,"",0,0,0,0,1,0,0,0,1,0,0
fbbb9269,Youssouf Sabaly,30,Betis,La Liga,11.6,1993,DF,3,3,6,8,66.7,12,4,27,0,11,16,1,12,27,3,11
fbd6378b,Aissa Mandi,31,Villarreal,La Liga,12.4,1991,DF,3,7,10,7,50.0,14,7,41,0,8,13,0,8,21,5,8
fc027d02,Luke Thomas,22,Sheffield Utd,Premier League,10.2,2001,DF,18,5,23,8,57.1,14,6,27,0,10,20,1,13,30,6,9
fc076f78,Luca Koleosho,18,Burnley,Premier League,10.8,2004,"MF,FW",13,0,13,2,20.0,10,8,0,0,2,7,0,2,9,5,4
fc15fb84,Dwight McNeil,23,Everton,Premier League,32.1,1999,"MF,FW",37,7,44,24,43.6,55,31,37,0,22,44,14,16,66,14,27
fc46aab1,Lovro Majer,25,Wolfsburg,Bundesliga,23.4,1998,"MF,FW",19,1,20,12,38.7,31,19,13,0,12,39,0,17,51,22,18
fc4cf6a7,Jordan Lotomba,24,Nice,Ligue 1,20.0,1998,DF,21,9,30,25,71.4,35,10,26,1,16,36,9,18,52,9,28
fc62fdf4,Roberto Massimo,22,Stuttgart,Bundesliga,0.9,2000,"FW,DF",0,0,0,1,50.0,2,1,1,0,0,1,0,1,1,0,0
fc647b34,Oscar Trejo,35,Rayo Vallecano,La Liga,15.3,1988,"FW,MF",20,1,21,13,61.9,21,8,9,0,5,27,7,11,32,9,15
fc8b614b,Jose Pozo,27,Rayo Vallecano,La Liga,0.2,1996,MF,1,0,1,1,100.0,1,0,0,0,0,1,0,0,1,1,1
fcb27134,Mohamed Simakan,23,RB Leipzig,Bundesliga,23.8,2000,DF,22,14,36,32,72.7,44,12,69,0,29,48,1,28,77,19,29
fcb9b1f8,Dembo Sylla,20,Lorient,Ligue 1,0.5,2002,DF,0,0,0,0,"",0,0,2,0,1,1,0,0,2,1,1
fcc84a07,Leo Leroy,23,Montpellier,Ligue 1,5.5,2000,MF,9,3,12,6,28.6,21,15,8,0,7,19,3,8,26,8,10
fce2302c,Kieran Tierney,26,Real Sociedad,La Liga,13.8,1997,DF,14,8,22,18,66.7,27,9,45,0,10,37,3,16,47,18,24
fce521d7,"Ricard Sanchez ",23,Granada,La Liga,25.5,2000,DF,28,4,32,12,50.0,24,12,64,0,13,29,6,15,42,8,18
fd2bc67d,Dante,39,Nice,Ligue 1,31.6,1983,DF,21,22,43,38,73.1,52,14,77,2,37,62,2,44,99,16,30
fd51b456,Lucas Vazquez,32,Real Madrid,La Liga,15.8,1991,DF,22,5,27,18,72.0,25,7,36,0,12,37,1,22,49,14,25
fd53759d,Jan Thielmann,21,Köln,Bundesliga,17.5,2002,"FW,DF",25,6,31,12,50.0,24,12,28,0,8,28,6,13,36,9,18
fd82af8c,Kevin Sessa,23,Heidenheim,Bundesliga,11.2,2000,"MF,FW",11,1,12,7,43.8,16,9,17,0,4,17,2,9,21,6,10
fd987f24,Steven Shpendi,20,Empoli,Serie A,4.6,2003,"FW,MF",1,1,2,0,0.0,4,4,0,0,1,0,0,0,1,0,0
fdbe14c8,Jovan Milosevic,18,Stuttgart,Bundesliga,0.3,2005,"FW,MF",0,0,0,0,"",0,0,0,0,0,0,0,0,0,0,0
fdd26d71,Fabrizio Angileri,29,Getafe,La Liga,1.8,1994,"DF,MF",0,0,0,1,33.3,3,2,8,0,4,1,0,1,5,0,1
fdf3cb77,Vladimir Coufal,30,West Ham,Premier League,34.8,1992,DF,34,15,49,38,50.7,75,37,97,0,43,64,2,50,107,12,41
fdf4b948,Jean-Daniel Akpa-Akpro,30,Monza,Serie A,7.8,1992,MF,6,4,10,3,33.3,9,6,15,1,12,20,2,14,32,4,11
fe012aca,Jeremie Boga,26,Nice,Ligue 1,22.2,1997,FW,24,2,26,10,50.0,20,10,4,0,8,18,2,6,26,10,7
fe6e7156,Savio,19,Girona,La Liga,33.1,2004,"FW,MF",34,0,34,16,57.1,28,12,11,1,18,42,6,14,60,22,25
feb5d972,Pape Matar Sarr,20,Tottenham,Premier League,23.0,2002,MF,16,5,21,15,41.7,36,21,28,1,31,34,6,11,65,17,24
fed17f5a,Carlos Soler,26,Paris S-G,Ligue 1,12.1,1997,"MF,DF",7,3,10,6,28.6,21,15,11,1,5,15,4,9,20,2,10
fed7cb61,Kai Havertz,24,Arsenal,Premier League,29.3,1999,"MF,FW",25,1,26,14,35.9,39,25,22,0,20,35,7,7,55,21,15
fed96827,Chris Mepham,25,Bournemouth,Premier League,6.9,1997,DF,7,6,13,9,64.3,14,5,30,1,7,12,0,9,19,3,11
ff579c7e,Nikola Moro,25,Bologna,Serie A,9.3,1998,MF,13,1,14,8,53.3,15,7,10,0,7,21,1,8,28,12,16
ff5ea0bf,Malick Thiaw,21,Milan,Serie A,18.0,2001,DF,10,13,23,12,48.0,25,13,55,0,13,34,2,15,47,17,17
ff800ed8,Pol Lirola,25,Frosinone,Serie A,17.1,1997,DF,11,1,12,17,48.6,35,18,41,1,19,30,1,14,49,15,18
ff98492b,Robert Skov,27,Hoffenheim,Bundesliga,14.0,1996,"DF,FW",13,4,17,17,47.2,36,19,23,1,10,24,1,15,34,8,16
ffa90327,Anwar El Ghazi,28,Mainz 05,Bundesliga,0.6,1995,"MF,DF",0,0,0,0,0.0,1,1,0,0,0,0,0,0,0,0,0
ffacd3d5,Manu Sanchez,22,Celta Vigo,La Liga,19.7,2000,"DF,MF",20,3,23,31,56.4,55,24,65,0,19,54,8,21,73,25,28
ffbbc83b,Florian Grillitsch,27,Hoffenheim,Bundesliga,25.5,1995,"DF,MF",21,20,41,22,40.7,54,32,90,2,52,54,4,31,106,19,28
fffea3e5,Jeremy Doku,21,Rennes,Ligue 1,1.2,2002,FW,0,0,0,1,100.0,1,0,0,0,0,2,1,1,2,0,2
